"a" = (/turf/grass,/area)
"b" = (/turf/dgrass,/area)
"c" = (/obj/Tree/Tree2,/turf/grass,/area)
"d" = (/turf/beach,/area)
"e" = (/obj/Tree/Tree1,/turf/grass,/area)
"f" = (/turf/Lgrass,/area)
"g" = (/turf/gravel,/area)
"h" = (/turf/sand,/area)
"i" = (/turf/dirt,/area)
"j" = (/obj/Tree/Tree2,/turf/dgrass,/area)
"k" = (/turf/water,/area)
"l" = (/mob/vegeta,/turf/water,/area)
"m" = (/obj/Tree/Tree1,/turf/water,/area)
"n" = (/mob/goku,/turf/sand,/area)
"o" = (/mob/tien,/turf/dirt,/area)
"p" = (/mob/krillin,/turf/dgrass,/area)
"q" = (/mob/piccolo,/turf/dirt,/area)
"r" = (/mob/gohan,/turf/dirt,/area)

(1,1,1) = {"
bbbbbbbbbbbbbbbbbbbbbbbbbbbbbbbbbbbbbbbaaaaaaaaaaaaaaaaaaaaahhhhdkkddddddddddddkddhhhhhhhhhhhhhhhhhh
bbbbbbbbbbbbbbbbbbbbbbbbbbbbbbbbbbbbbbbaaaaaaaaaaaaaaaaaaaaahhhhdkkkdddddddddddkkddhhhhhhhhhhhhhhhhh
bjbbbbbbbbbbbjbbbbbbbbbbbjbbbbbbbjbbbbbaaaaaaaaaaaaaaaaaaaaaahhhdkkkkddddddddddkkkddhhhhhnhhhhhhhhhh
bbbbbbbbbbbbbbbbbbbbbbbbbbbbbbbbbbbbbbbbaaaaaaaaaaaaaaaaaaaaahhhdkkkkkddddddddkkkkkdddhhhhhhhhhhhhhh
bbbbbbbbjbbbbbbbbbjbbbjbbbbbbbbjbbbbbbbbbaaaaaaaaaaaaaaaaaaaahhhdkkkkkkkkkkkkkkkkkkkddhhhhhhhhhhhhhh
bbbjbbbbbbbbbjbbbbbbbbbbbbbbbbbbbbbbbbbbbaaaaaaaaaaaaaaaaaaaahhhdkkkkkkkkkkkkkkkkkkkkdddhhhhhhhhhhhh
bbbbbbbbbbbbbbbbbbbbbbbbbbbbjbbbbbbbbbbbbbaaaaaaaaaaaaaaaaaaahhhddkkkkkkkkkkkkkkkkkkkkddddhhhhhhhhhh
jbbbbbbbbbbbbbbbbbbbbbbbbbbbbbbbbbbbbbbbbbaaaaaaaaaaaaaaaaaaahhhddkkkkkkkkkkkkkkkkkkkkkkdddddhhhhhhh
bbbbbjbbbbbbbbbbbbbbbbbbbbbbbaaaaaaabbbbbbaaaaaaaaaaaaaaaaaaahhhddkkkkkkkkkkkkkkkkkkkkkkkkddddddhhhh
bbbbbbbbbbbbbbbbbbbbbbbaaaaaaaaaaaaaabbbbbaaaaaaaaaaaaaaaaaaaahhhddkkkkkkkkkkkkkkkkkkkkkkkkkkdddddhh
bjbbbbbbbbbbbbaaaaaaaaaaaaaaaaaaakaaabbbbbaaaaaaaaaaaaaaaaaaaahhhhddkkkkkkkkkkkkkkkkkkkkkkkkkkkkdddh
bbbbbbbbbbbbbaaaaaaaaaaaaaaaaaaakkaaaaabbbaaaaaaaaaaaaaaaaaaaaahhhhdddkkkkkkkkkkkkkkkkkkkkkkkkkkkkdh
bbbbbbbbbbbbbaaaaaaaaaaaaaaaaaaakkaaaaaabbaaaaaaaaaaaaaaaaaaaaaahhhhhddkkkkkkkkkkkkkkkkkkkkkkkkkkddh
bbbbbbbbbbbbbaaaaaaaaaaaaaaaaaaakkaaaaaabbaaaaaaaaaaaaaaaaaaaaaaahhhhhdkkkkkkkkkkkkkkkkkkkkkkkdddddd
bbbbbbbbbbbbaaaaaaaaaaaaaaaaaaakkaaaaaaaaaaaaaaaaaaaaaaaaaaaaaaaaahhhhdkkkkkkkkkkkkkkkkkkkkkkdddddkk
bjbbbbbbbbbaaaaaaaaaaaaaaaaaaaakkaaaaaaaaaaaaaaaaaaaaaaaaaaaaaaaaaahhhddkkkkkkkkkkkkkkkkkkkkdddkkkkk
bbbbbbbbbbbaaaaaaaaaaakkkaaaaakkaaaaaaaaaaaaaaaaaaaaaaaaaaaaaaaaaaahhhhdkkkkkkkkkkkkkkkkkkkkddkkkkkk
bbbbbjbbbpaaaaaaaaaaakkkkaaaaakkaaaaaaaaaaaaaaaaaaaaaaaaaaaaaaaaaaahhhhdkkkkkkkkkkkkkkkkkkkkkkkkkkkk
bbbbbbbbbbaaaaaaaaaakkkkkaaaaakkaaaaaaaaaaaaaaaaaaaaaaaaaaaaaaaaaaaaahhddkkkkkkkkkkkkkkkkkkkkkkkkkkk
bbbbbbbbbbaaaaaaaaaaakkkaaaaakkkaaaaaaaaaaaaaaaaaaaaaaaaaaaaaaaaaaaaaahhdddkkkkkkkkkkkkkkkkkkkkkkkkk
bbbbbbbbbbacaaaaaaaaaakaaaaakkkkaaaaaaaaaaaaaaaaaaaaaaaaaaaaaaaaaaaaaahhhddddkkkkkkkkkkkkkkkkkkkkkkk
bbbbbbbbbbaaaaaaaaaaaaaaaaaakkaaaaaaaaaaaaaaaaaaaaaaaaaaaaaaaaaaaaaaaahhhhhddddddddkkkkkkkkkkkkkkkkk
bbjbbbbbbaaaaaaaaaaaaaaaaaaakkaaaaaaaaaaaaaaaaaaaaaaaaaaaaaaaaaaaaaaaaahhhhhhhhhhhdkkkkkkkkkkkkkkkkk
bbbbbbbbbaaaaaaaaaaaaaaaaaaakkaaaaaaaaaaaaaaaaaaaaaaaaaaaaaaaaaaaaaaaaaahhhhhhhhhhddkkkkkkkkkkkkkkkk
bbbbbbbbbaaaaaaaaaaaaaaaaaaakkkaaaaaaaaaaaaaaaaaaaaaaaaaaaaaaaaaaaaaaaaahhhhhhhhhhhdkkkkkkkkkkkkkkkk
bbbbjbbbaaaaaaaaaaaaaaaaaaakkkkkaaaaaaaaaaaaaaaaaaaaaaaaaaaaaaaaaaaaaaaaahhhhhhhhhhdddkkkkkkkkkkkkkk
jbbbbbbbaaaaaaaaaaaaaaaaaaakkakkkaaaaaaaaaaaaaaaaaaaaaaaaaaaaaaaaaaaaaaaahhhhhhhhhhhddddddkkkkkkkkkk
bbbbbbbbaaaaaaaaaaaaaaaaaaakkaakkkaaaaaaaaaaaaaaaaaaaaaaaaaaaaaaaaaaaaaaahhhhhhhhhhhhhhhhdddkkkkkkkk
bbbbbjbbaaaaaaaaaaaaaaaaakkkkaaakkkaaaaaaaaaaaaaaaaaaaaaaaaaaaaaaaaaaaaaaaahhhhhhhhhhhhhhhhddddkkkkk
bbbbbbbaaaaaaaaaaaaaaaaakkkkaaaaakkkaaaaaaaaaaaaaaaaaaaaaaaaaaaaaaaaaaaaaaaaaahhhhhhhhhhhhhhhhdddddd
bbbbbbbaaaaaaaaaaaaaaaaakkkkaaaaaakkkaaaaaaaaaaaaaaaaaaaaaaaaaaaaaaaaaaaaaaaaaaaaaaaahhhhhhhhhhhhhhh
bjbbbbbaaaaaaaaaaaaaaaaakkkaaaaaaaakkkaaaaaaaaaaaaaaaaaaaaaaaaaaaaaaaaaaaaaaaaaaaaaaaahhhhhhhhhhhhhh
bbbbaaaaaaaaaaaaaaaaaaakkkkaaaaaaaaakkaaaaaaaaaaaaaaaaaaaaaaaaaaaaaaaaaaaaaaaaaaaaaaaaaaaahhhhhhhhhh
bbbaaaaaaaaaaaaaaaaaaaakkkkaaaaaaaaakkkaaaaaaaaaaaaaaaaaaaaaaaaaaaaaaaaaaaaaaaaaaaaaaaaaaaahhhhhhhhh
bbaaaaaaaaaaaaaaaaaaaaakkaaaaaaaaaaaakkaaaaaaaaaaaaaaaaaaaaaaaaaaaaaaaaaaaaaaaaaaaaaaaaaaaaaaahhhhhh
baaaaaaaaaaaaaaaaaaaaaakkaaaaaaaaaaaakkaaaaaaaaaaaaaaaaaaaaaaaaaaaaaaaaaaaaaaaaaaaaaaaaaaaaaaaahhhhh
aaaaaaaaaaaaaaaaaaaaaaakkaaaaaaaaaaaaakkaaaaaaaaaaaaaaaaaaaaaaaaaaaaaaaaaaaaaaaaaaaaaaaaaaaaaaaaahhh
aaaaaaaaaaaaaaaaaaaaaaakkaaaaaaaaaaaaakkkaaaaaaaaaaaaaaaaaaaaaaaaaaaaaaaaaaaaaaaaaaaaaaaaaaaaaaaaaaa
aaaaaaaaaaaaaaaaaaaaaakkkaaaaaaaaaaaaaakkaaaaaaaaaaaaaaaaaaaaaaaaaaaaaaaaaaaaaaaaaaaaaaaaaaaaaaaaaaa
aaaaaaaaaaaaaaaaaaaaaakkkaaaaaaaaaaaaaakkaaaaaaaaaaaaaaaaaaaaaaaaaaaaaaaaaaaaaaaaaaaaaaaaaaaaaaaaaaa
aaaaaaaaaaaaaaaaaaaaaakkaaaaaaaaaaaaaaaakkaaaaaaaaaaaaaaaaaaaaaaaaaaaaaaaaaaaaaaaaaaaaaaaaaaaaaaaaaa
aaaaaaaaaaaaaaaaaaaaaakkaaaaaaaaaaaaaaaaaakaaaaaaaaaaaaaaaaaaaaaaaaaaaaaaaaaaaaaaaaaaaaaaaaaaaaaaaaa
aaaaaaaaaaaaaaaaaaaaaakkaaaaaaaaaaaaaaaaaaaaaaaaaaaaaaaaaaaaaaaaaaaaaaaaaaaaaaaaaaaaaaaaaaaaaaaaaaaa
aaaaaaaaaaaaaaaaaaaaaakkaaaaaaaaaaaaaaaaaaaaaaaaaaaaaaaaaaaaaaaaaaaaaaaaaaaaaaaaaaaaaaaaaaaaaaaaaaaa
aaaaaaaaaaaaaaaaaaaaaakkaaaaaaaaaaaaaaaaaaaaaaaaaaaaaaaaaaaaaaaaaaaaaaaaaaaaaaaaaaaaaaaaaaaaaaaaaaaa
aaaaaaaaaaaaaaaaaaaaaakkaaaaaaaaaaaaaaaaaaaaaaaaaaaaaaaaaaaaaaaaaaaaaaaaaaaaaaaaaaaaaaaaaaaaaaaaaaaa
aaaaaaaaaaaaaaaaaaaaakkkaaaaaaaaaaaaaaaaaaaaaaaaaaaaaaaaaaaaaaaaaaaaaaaaaaaaaaaaaaaaaaaaaaaaaaaaaaaa
aaaaaaaaaaaaaaaaaaaaakkkaaaaaaaaaaaaaaaaaaaaaaaaaaaaaaaaaaaaaiaaaaaaaaaaaaaaaaaaaaaaaaaaaaaaaaaaaaaa
aaaaaaaaaaaaaaaaaaaaakkaaaaaaaaaaaaaaaaaaaaaaaaaaaaaaaaaaaaaiiiaaaaaaaaaaaaaaaaaaaaaaaaaaaaaaaaaaaaa
aaaaaaaaaaaaaaaaaaaaakkaaaaaaaaaaaaaaaaaaaaaaaaaaaaaaaaaaaiiiiiiaaaaaaaaaaaaaaaaaaaaaaaaaaaaaaaaaaaa
aaaaaaaaaaaaaaaaaaaaakkaaaaaaaaaaaaaaaaaaaaaaaaaaaaaaaaaiiiiiiiiiaaaaaaaaaaaaaaaaaaaaaaaaaaaaaaaaaaa
aaaaaaaaaaaaaaaaaaaaakkaaaaaaaaaaaaaaaaaaaaaaaaaaaaaaaaiiiiiiiiiiaaaaaaaaaaaaaaaaaaaaaaaaaaaaaaaaaai
aaaaaaaaaaaaaaaaaaaaakkaaaaaaaaaaaaaaaaaaaaaaaaaaaaaaaaiiqiiriiiiiaaaaaaaaaaaaaaaaaaaaaaaaaaaaaaaiii
aaaaaaaaaaaaaaaaaaaaakkaaaaaaaaaaaaaaaaaaaaaaaaaaaaaaaaaiiiiiiiiiiaaaaaaaaaaaaaaaaaaaaaaaaaaaaiiiiii
aaaaaabbbbbaaaaaaaaaakkaaaaaaaaaaaaaaaaaaaaaaaaaaaaaaaaaaiiiiiiiiiaaaaaaaaaaaaaaaaaaaaaaaaaiiiiiiiii
aaaabbbbbbaaaaaaaaaakkaaaaaaaaaaaaaaaaaaaaaaaaaaaaaaaaaaaiiiiiiaaaaaaaaaaaaaaaaaaaaaaaaaaiiiiiiiiiii
aaabbbbbbaabbbaaaaaakkaaaaaaaaaaaaaaaaaaaaaaaaaaaaaaaaaaaiiiiiaaaaaaaaaaaaaaaaaaaaaaaaaaiiiiiiiiiiii
aabbbbbbbabbbaaaaaaakkaaaaaagaaaaaaaaaaaaaaaaaaaaaaaaaaaaaaaaaaaaaaaaaaaaaaaaaaaaaaaaaaiiiiiiiiiiiii
aabbbbbbbbbbbaaaaaaakkaaaaaagaaaaaaaaaaaaaaaaaaaaaaaaaaaaaaaaaaaaaaaaaaaaaaaaaaaaaaaaiiiiiiiiiiiiiii
aabbbbbbbbbbbaaaaaaakkaaaaaaaaaaaaaaaaaaaaaaaaaaaaaaaaaaaaaaaaaaaaaaaaaaaaaaaaaaaaaaiiiiiiiiiiiiiiii
aabbbbbbbbbbaaaaaaakkkaaaaaaagaaaaaaaaaaaaaaaaaaaaaaaaaaaaaaaaaaaaaaaaaaaaaaaaaaaaiiiiiiiiiiiiiiiiii
aaaabbbbbbbbaaaaaaakkaaaaaaaggaaaaaaaaaaaaaaaaaaaaaaaaaaaaaaaaaaaaaaaaaaaaaaaaaaaaiiiiiiiiiiiiiiiiii
aaaabbbbbbbaaaaaaaakkaggggggggaaaaaaaaaaaaaaaaaaaaaaaaaaaaaaaaaaaaaaaaaaaaaaaaaaaiiiiiiiiiiiiiiiiiii
aaabbbbbbaaaaaaaaaakkaaaggggggaaaaaaaaaaaaaaaaaaaaaaaaaaaaaaaaaaaaaaaaaaaaaaaaaiiiiiiiiiiiiiiiiiiiii
aabbbaaabaaaaaaaaaakkaaaaaaaggaaaaaaaaaaaaaaaaaaaaaaaaaaaaaaaaaaaaaaaaaaaaaaaaiiiiiiiiiiiiiiiiiiiiii
aaabaaaaaaaaaaaaaaakkaaaaaaaggaaaaaaaaaaaaaaaaaaaaaaaaaaaaaaaaaaaaaaaaaaaaaaaiiiiiiiiiiiiiiiiiiiiiii
aaaaaaaaaaaaaaaaaaakkaaaaaaaggaaaaaaaaaaaaaaaaaaaaaaaaaaaaaaaaaaaaaaaaaaaaaaaiiiiiiiiiiiiiiiiiiiiiii
aaaaaaaaaaaaaaaaaaakkaaaaaaaggaaaaaaaaaaaaaaaaaaaaaaaaaaaaaaaaaaaaaaaaaaaaaiiiiiiiiiiiiiiiiiiiiiiiii
aaaaaaaaaaaaaaaaaaakkaaaaaaaggaaaaaaaaaaaaaaaaaaaaaaaaaaaaaaaaaaaaaaaaaaaaiiiiiiiiiiiiiiiiiiiiiiiiii
aaaaaaaaaaaaaaaaaaakkaaaaaaaggaaaaaaaaaaaaaaaaaaaaaaaaaaaaaaaaaaaaaaaaaaaiiiiiiiiiiiiiiiiiiiiiiiiiii
aaaaaaaaaaaaaaaaaaakkaaaaaaaggaaaaaaaaaaaaaaaaaaaaaaaaaaaaaaaaaaaaaaaaaaiiiiiiiiiiiiiiiiiiiiiiiiiiii
aaaaaaaaaaaaaaaaaakkkaaaaaaaggaaaaaaaaaaaaaaaaaaaaaaaaaaaaaaaaaaaaaaaaiiiiiiiiiiiiiiiiiiiiiiiiiiiiii
aaaaaaaaaaaaaaaaaakkaaaaaaaagggggggggaggaaaaaaaaaaaaaaaaaaaaaaaaaaaaaiiiiiiiiiiiiiiiiiiiiiiiiiiiiiii
aaaaaaaaaaaaaaaaaaklaaaaaaaaggggggggggaggaaaaaaaaaaaaaaaaaaaaaaaaaaaiiiiiiiiiiiiiiiiiiiiiiiiiiiiiiii
aaaaaaaaaaaaaaaaaakkaaaaaaagggaaaaaaaaaaaaaaaaaaaaaaaaaaaaaaaaaaaaaiiiiiiiiiiiiiiiiiiiiiiiiiiiiiiiii
aaaaaaaaaaaaaaaaaakkaaaaaaggggaaaaaaaaaaaaaaaaaaaaaaaaaaaaaaaaaaaaiiiiiiiiiiiiiiiiiiiiiiiiiiiiiiiiii
aaaaaaaaaaaaaaaaaakkaaaaaggggaaaaaaaaaaaaaaaaaaaaaaaaaaaaaaaaaaaaiiiiiiiiiiiiiiiiiiiiiiiiiiiiiiiiiii
aaaaaaaaaaaaaaaaaakkaaagggaaaaaaaaaaaaaaaaaaaaaaaaaaaaaaaaaaaaaaiiiiiiiiiiiiiiiiiiiiiiiiiiiiiiiiiiii
aaaaaaaaaffaffaaaakkaaagggaaaaaaaaaaaaaaaaaaaaaaaaaaaaaaaaaaaaaiiiiiiiiiiiiiiiiiiiiiiiiiiiiiiiiiiiii
aaaaaaffffffffaaaakkaaaggaaaaaaaaaaaaaaaaaaaaaaaaaaaaaaaaaaaaaiiiiiiiiiiiiiiiiiiiiiiiiiiiiiiiiiiiiii
aaaaaaaffffaaaaaaakkaaggaaaaaaaaaaaaaaaaaaaaaaaaaaaaaaaaaaaaaiiiiiiiiiiiiiiiiiiiiiiiiiiiiiiiiiiiiiii
aaaaaaaffaaaaaaaaakkaaaaaaaaaaaaaaaaaaaaaaaaaaaaaaaaaaaaaaaaiiioiiiiiiiiiiiiiiiiiiiiiiiiiiiiiiiiiiii
aaaaaaaaaaaaaaaaaakkaaaaaaaaaaaaaaaaaaaaaaaaaaaaaaaaaaaaaaaiiiiiiiiiiiiiiiiiiiiiiiiiiiiiiiiiiiiiiiii
aaafaaaaaaaaaaaaaakkaaaaaaaaaaaaaaaaaaaaaaaaaaaaaaaaaaaaaaiiiiiiiiiiiiiiiiiiiiiiiiiiiiiiiiiiiiiiiiii
aaaffaffffffaaaaaakkaaaaaaaaaaaaaaaaaaaaaaaaaaaaaaaaaaaaaiiiiiiiiiiiiiiiiiiiiiiiiiiiiiiiiiiiiiiiiiii
aaaffaffffffaaaaaakkaaaaaaaaaaaaaaaaaaaaaaaaaaaaaaaaaaaaiiiiiiiiiiiiiiiiiiiiiiiiiiiiiiiiiiiiiiiiiiii
aaaffffffaaaaaaaaakmaaaaaaaaaaaaaaaaaaaaaaaaaaaaaaaaiiiiiiiiiiiiiiiiiiiiiiiiiiiiiiiiiiiiiiiiiiiiiiii
aaaffffffffaaaaaaakkaaaaaaaaaaaaaaaaaaaaaaaaaaaaaaiiiiiiiiiiiiiiiiiiiiiiiiiiiiiiiiiiiiiiiiiiiiiiiiii
aaaffaafffeaaaaaaakkaaaaaaaaaaaaaaaaaaaaaaaaaaaaaiiiiiiiiiiiiiiiiiiiiiiiiiiiiiiiiiiiiiiiiiiiiiiiiiii
aaaaaaaffaaaaaaaaakkaaaaaaaaaaaaaaaaaaaaaaaaaaaiiiiiiiiiiiiiiiiiiiiiiiiiiiiiiiiiiiiiiiiiiiiiiiiiiiii
aaaaaaffffaafffaaakkaaaaaaaaaaaaaaaaaaaaaaaaaaaiiiiiiiiiiiiiiiiiiiiiiiiiiiiiiiiiiiiiiiiiiiiiiiiiiiii
aaaaaaafffffffaaaakkaaeaaaaaaaaaaaaaaaaaaaaaaaiiiiiiiiiiiiiiiiiiiiiiiiiiiiiiiiiiiiiiiiiiiiiiiiiiiiii
baaaaffffffffaaaaakkaaaaaaaaaaaaaaaaaaaaaaaaaiiiiiiiiiiiiiiiiiiiiiiiiiiiiiiiiiiiiiiiiiiiiiiiiiiiiiii
baaaaffffffaaaaaaakkaaaaaaaaaaaaaaaaaaaaaaaaaiiiiiiiiiiiiiiiiiiiiiiiiiiiiiiiiiiiiiiiiiiiiiiiiiiiiiii
baaaaaffffaaaaaaaakkaaaaaaaaaaaaaaaaaaaaaaaaaiiiiiiiiiiiiiiiiiiiiiiiiiiiiiiiiiiiiiiiiiiiiiiiiiiiiiii
baaaaaaaaaaaaaaaaakkaaaaaaaaaaaaaaaaaaaaaaaaaiiiiiiiiiiiiiiiiiiiiiiiiiiiiiiiiiiiiiiiiiiiiiiiiiiiiiii
bbaaaaaaaaaaaaaaaakkaaaaaaaaaaaaaaaaaaaaaaaaiiiiiiiiiiiiiiiiiiiiiiiiiiiiiiiiiiiiiiiiiiiiiiiiiiiiiiii
bbbbaaaaaaaaaaaaaakkaaaaaaaaaaaaaaaaaaaaaaaiiiiiiiiiiiiiiiiiiiiiiiiiiiiiiiiiiiiiiiiiiiiiiiiiiiiiiiii
bbbbbbbbbaaaaaaaaakkaaaaaaaaaaaaaaaaaaaaaaiiiiiiiiiiiiiiiiiiiiiiiiiiiiiiiiiiiiiiiiiiiiiiiiiiiiiiiiii
bbbbbbbbbbbbbaaaakkkaaaaaaaaaaaaaaaaaaaaaaiiiiiiiiiiiiiiiiiiiiiiiiiiiiiiiiiiiiiiiiiiiiiiiiiiiiiiiiii
"}
