"aa" = (/turf/grass,/area)
"ab" = (/turf/dgrass,/area)
"ac" = (/obj/Tree/Tree2,/turf/grass,/area)
"ad" = (/turf/beach,/area)
"ae" = (/obj/Tree/Tree1,/turf/grass,/area)
"af" = (/turf/Lgrass,/area)
"ag" = (/turf/gravel,/area)
"ah" = (/turf/sand,/area)
"ai" = (/turf/dirt,/area)
"aj" = (/obj/Tree/Tree2,/turf/dgrass,/area)
"ak" = (/turf/water,/area)
"al" = (/mob/vegeta,/turf/water,/area)
"am" = (/obj/Tree/Tree1,/turf/water,/area)
"an" = (/mob/goku,/turf/sand,/area)
"ao" = (/mob/tien,/turf/dirt,/area)
"ap" = (/mob/krillin,/turf/dgrass,/area)
"aq" = (/mob/piccolo,/turf/dirt,/area)
"ar" = (/mob/gohan,/turf/dirt,/area)
"as" = (/mob/yamcha,/turf/dirt,/area)
"at" = (/turf_overlays/rocks/rock4,/turf/grass,/area)
"au" = (/turf_overlays/rocks/rock5,/turf/grass,/area)
"av" = (/turf_overlays/rocks/rock5,/turf/dirt,/area)
"aw" = (/turf_overlays/rocks/rock6,/turf/dirt,/area)
"ax" = (/turf_overlays/mushroom/mushroom3,/turf/dirt,/area)
"ay" = (/turf_overlays/leaf/leaf4,/turf/grass,/area)
"az" = (/turf_overlays/leaf/leaf7,/turf/grass,/area)
"aA" = (/turf_overlays/leaf/leaf5,/turf/grass,/area)
"aB" = (/turf_overlays/mushroom/mushroom2,/turf/dirt,/area)
"aC" = (/turf_overlays/mushroom/mushroom1,/turf/dirt,/area)
"aD" = (/turf_overlays/rocks/rock2,/turf/dirt,/area)
"aE" = (/turf_overlays/rocks/rock1,/turf/dirt,/area)
"aF" = (/turf_overlays/rocks/rock3,/turf/dirt,/area)
"aG" = (/turf_overlays/rocks/rock7,/turf/dirt,/area)
"aH" = (/turf_overlays/shrub,/turf/grass,/area)
"aI" = (/obj/Rock/Rock6,/turf/grass,/area)
"aJ" = (/obj/Rock/Rock5,/turf/grass,/area)
"aK" = (/turf_overlays/flowers/flower6,/turf/dgrass,/area)
"aL" = (/turf_overlays/flowers/flower12,/turf/dgrass,/area)
"aM" = (/turf_overlays/flowers/flower9,/turf/dgrass,/area)
"aN" = (/turf_overlays/flowers/flower7,/turf/dgrass,/area)
"aO" = (/turf_overlays/flowers/flower10,/turf/dgrass,/area)
"aP" = (/turf_overlays/flowers/flower5,/turf/dgrass,/area)
"aQ" = (/turf_overlays/flowers/flower1,/turf/dgrass,/area)
"aR" = (/turf_overlays/flowers/flower4,/turf/dgrass,/area)
"aS" = (/turf_overlays/flowers/flower3,/turf/dgrass,/area)
"aT" = (/turf_overlays/flowers/flower11,/turf/dgrass,/area)
"aU" = (/turf_overlays/flowers/flower8,/turf/dgrass,/area)
"aV" = (/obj/Rock/Rock2,/turf/dirt,/area)
"aW" = (/turf_overlays/grass/grass8,/turf/grass,/area)
"aX" = (/turf_overlays/grass/grass6,/turf/grass,/area)
"aY" = (/turf_overlays/grass/grass7,/turf/grass,/area)
"aZ" = (/turf_overlays/grass/grass5,/turf/grass,/area)
"ba" = (/obj/Rock/Rock3,/turf/dirt,/area)
"bb" = (/obj/Rock/Rock4,/turf/dirt,/area)
"bc" = (/obj/Rock/Rock1,/turf/dirt,/area)

(1,1,1) = {"
abababababababababababababababababababababababababababababababababababababababaaaaaaaaaaaaaaaaaaaaaaaaaaaaaaaaaaaaaaaaaaahahahahadakakadadadadadadadadadadadadakadadahahahahahahahahahahahahahahahahahah
abababababababababababababababababababababababababababababababababababababababaaaaaaaaaaaaaaaaaaaaaaaaaaaaaaaaaaaaaaaaaaahahahahadakakakadadadadadadadadadadadakakadadahahahahahahahahahahahahahahahahah
abajabababababababababababajabababababababababababajabababababababajabababababaaaaaaaaaaaaaaaaaaaaaaaaaaaaaaaaaaaaaaaaaaaaahahahadakakakakadadadadadadadadadadakakakadadahahahahahanahahahahahahahahahah
ababababababababababababababababababababababababababababababababababababababababaaaaaaaaaaaaaaaaaaaaaaaaaaaaaaaaaaaaaaaaaaahahahadakakakakakadadadadadadadadakakakakakadadadahahahahahahahahahahahahahah
ababababababababajabababababababababajabababajababababababababajabababababababababaaaaaaaaaaaaaaaaaaaaaaaaaaaaaaaaaaaaaaaaahahahadakakakakakakakakakakakakakakakakakakakadadahahahahahahahahahahahahahah
abababajabababababababababajabababababababababababababababababababababababababababaaaaaaaaaaaaaaaaaaaaaaaaaaaaaaaaaaaaaaaaahahahadakakakakakakakakakakakakakakakakakakakakadadadahahahahahahahahahahahah
ababababababababababababababababababababababababababababajabababababababababababababaaaaaaaaaaaaaaaaaaaaaaaaaaaaaaaaaaaaaaahahahadadakakakakakakakakakakakakakakakakakakakakadadadadahahahahahahahahahah
ajabababababababababababababababababababababababababababababababababababababababababaaaaaaaaaaaaaaaaaaaaaaaaaaaaaaaaaaaaaaahahahadadakakakakakakakakakakakakakakakakakakakakakakadadadadadahahahahahahah
abababababajabababababababababababababababababababababababaaaaaaaaaaaaaaababababababaaaaaaaaaaaaaaaaaaaaaaaaaaaaaaaaaaaaaaahahahadadakakakakakakakakakakakakakakakakakakakakakakakakadadadadadadahahahah
abababababababababababababababababababababababaaaaaaaaaaaaaaaaaaaaaaaaaaaaabababababaaaaaaaaaaaaaaaaaaaaaaaaaaaaaaaaaaaaaaaaahahahadadakakakakakakakakakakakakakakakakakakakakakakakakakakadadadadadahah
abajababababababababababababaaaaaaaaaaaaaaaaaaaaaaaaaaaaaaaaaaaaaaakaaaaaaabababababaaaaaaaaaaaaaaaaaaaaaaaaaaaaaaaaaaaaaaaaahahahahadadakakakakakakakakakakakakakakakakakakakakakakakakakakakakadadadah
abababababababababababababaaaaaaaaaaaaaaaaaaaaaaaaaaaaaaaaaaaaaaakakaaaaaaaaaaabababaaaaaaaaaaaaaaaaaaaaaaaaaaaaaaaaaaaaaaaaaaahahahahadadadakakakakakakakakakakakakakakakakakakakakakakakakakakakakadah
abababababababababababababaaaaaaaaaaaaaaaaaaaaaaaaaaaaaaaaaaaaaaakakaaaaaaaaaaaaababaaaaaaaaaaaaaaaaaaaaaaaaaaaaaaaaaaaaaaaaaaaaahahahahahadadakakakakakakakakakakakakakakakakakakakakakakakakakakadadah
abababababababababababababaaaaaaaaaaaaaaaaaaaaaaaaaaaaaaaaaaaaaaakakaaaaaaaaaaaaababaaaaaaaaaaaaaaaaaaaaaaaaaaaaaaaaaaaaaaaaaaaaaaahahahahahadakakakakakakakakakakakakakakakakakakakakakakakadadadadadad
ababababababababababababaaaaaaaaaaaaaaaaaaaaaaaaaaaaaaaaaaaaaaakakaaaaaaaaaaaaaaaaaaaaaaaaaaaaaaaaaaaaaaaaaaaaaaaaaaaaaaaaaaaaaaaaaaahahahahadakakakakakakakakakakakakakakakakakakakakakakadadadadadakak
abajabababababababababaaaaaaaaaaaaaaaaaaaaaaaaaaaaaaaaaaaaaaaaakakaaaaaaaaaaaaaaaaaaaaaaaaaaaaaaaaaaaaaaaaaaaaaaaaaaaaaaaaaaaaaaaaaaaaahahahadadakakakakakakakakakakakakakakakakakakakakadadadakakakakak
abababababababababababaaaaaaaaaaaaaaaaaaaaaaakakakaaaaaaaaaaakakaaaaaaaaaaaaaaaaaaaaaaaaaaaaaaaaaaaaaaaaaaaaaaaaaaaaaaaaaaaaaaaaaaaaaaahahahahadakakakakakakakakakakakakakakakakakakakakadadakakakakakak
abababababajabababapaaaaaaaaaaaaaaaaaaaaaaakakakakaaaaaaaaaaakakaaaaaaaaaaaaaaaaaaaaaaaaaaaaaaaaaaaaaaaaaaaaaaaaaaaaaaaaaaaaaaaaaaaaaaahahahahadakakakakakakakakakakakakakakakakakakakakakakakakakakakak
ababababababababababaaaaaaaaaaaaaaaaaaaaakakakakakaaaaaaaaaaakakaaaaaaaaaaaaaaaaaaaaaaaaaaaaaaaaaaaaaaaaaaaaaaaaaaaaaaaaaaaaaaaaaaaaaaaaaaahahadadakakakakakakakakakakakakakakakakakakakakakakakakakakak
ababababababababababaaaaaaaaaaaaaaaaaaaaaaakakakaaaaaaaaaaakakakaaaaaaaaaaaaaaaaaaaaaaaaaaaaaaaaaaaaaaaaaaaaaaaaaaaaaaaaaaaaaaaaaaaaaaaaaaaaahahadadadakakakakakakakakakakakakakakakakakakakakakakakakak
ababababababababababaaacaaaaaaaaaaaaaaaaaaaaakaaaaaaaaaaakakakakaaaaaaaaaaaaaaaaaaaaaaaaaaaaaaaaaaaaaaaaaaaaaaaaaaaaaaaaaaaaaaaaaaaaaaaaaaaaahahahadadadadakakakakakakakakakakakakakakakakakakakakakakak
ababababababababababaaaaaaaaaaaaaaaaaaaaaaaaaaaaaaaaaaaaakakaaaaaaaaaaaaaaaaaaaaaaaaaaaaaaaaaaaaaaaaaaaaaaaaaaaaaaaaaaaaaaaaaaaaaaaaaaaaaaaaahahahahahadadadadadadadadakakakakakakakakakakakakakakakakak
ababajababababababaaaaaaaaaaaaaaaaaaaaaaaaaaaaaaaaaaaaaaakakaaaaaaaaaaaaaaaaaaaaaaaaaaaaaaaaaaaaaaaaaaaaaaaaaaaaaaaaaaaaaaaaaaaaaaaaaaaaaaaaaaahahahahahahahahahahahadakakakakakakakakakakakakakakakakak
abababababababababaaaaaaaaaaaaaaaaaaaaaaaaaaaaaaaaaaaaaaakakaaaaaaaaaaaaaaaaaaaaaaaaaaaaaaaaaaaaaaaaaaaaaaaaaaaaaaaaaaaaaaaaaaaaaaaaaaaaaaaaaaaaahahahahahahahahahahadadakakakakakakakakakakakakakakakak
abababababababababaaaaaaaaaaaaaaaaaaaaaaaaaaaaaaaaaaaaaaakakakaaaaaaaaaaaaaaaaaaaaaaaaaaaaaaaaaaaaaaaaaaaaaaaaaaaaaaaaaaaaaaaaaaaaaaaaaaaaaaaaaaahahahahahahahahahahahadakakakakakakakakakakakakakakakak
ababababajabababaaaaaaaaaaaaaaaaaaaaaaaaaaaaaaaaaaaaaaakakakakakaaaaaaaaaaaaaaaaaaaaaaaaaaaaaaaaaaaaaaaaaaaaaaaaaaaaaaaaaaaaaaaaaaaaaaaaaaaaaaaaaaahahahahahahahahahahadadadakakakakakakakakakakakakakak
ajabababababababaaaaaaaaaaaaaaaaaaaaaaaaaaaaaaaaaaaaaaakakaaakakakaaaaaaaaaaaaaaaaaaaaaaaaaaaaaaaaaaaaaaaaaaaaaaaaaaaaaaaaaaaaaaaaaaaaaaaaaaaaaaaaahahahahahahahahahahahadadadadadadakakakakakakakakakak
ababababababababaaaaaaaaaaaaaaaaaaaaaaaaaaaaaaaaaaaaaaakakaaaaakakakaaaaaaaaaaaaaaaaaaaaaaaaaaaaaaaaaaaaaaaaaaaaaaaaaaaaaaaaaaaaaaaaaaaaaaaaaaaaaaahahahahahahahahahahahahahahahahadadadakakakakakakakak
abababababajababaaaaaaaaaaaaaaaaaaaaaaaaaaaaaaaaaaakakakakaaaaaaakakakaaaaaaaaaaaaaaaaaaaaaaaaaaaaaaaaaaaaaaaaaaaaaaaaaaaaaaaaaaaaaaaaaaaaaaaaaaaaaaaaahahahahahahahahahahahahahahahahadadadadakakakakak
abababababababaaaaaaaaaaaaaaaaaaaaaaaaaaaaaaaaaaakakakakaaaaaaaaaaakakakaaaaaaaaaaaaaaaaaaaaaaaaaaaaaaaaaaaaaaaaaaaaaaaaaaaaaaaaaaaaaaaaaaaaaaaaaaaaaaaaaaaaahahahahahahahahahahahahahahahahadadadadadad
abababababababaaaaaaaaaaaaaaaaaaaaaaaaaaaaaaaaaaakakakakaaaaaaaaaaaaakakakaaaaaaaaaaaaaaaaaaaaaaaaaaaaaaaaaaaaaaaaaaaaaaaaaaaaaaaaaaaaaaaaaaaaaaaaaaaaaaaaaaaaaaaaaaaaaaaaahahahahahahahahahahahahahahah
abajabababababaaaaaaaaaaaaaaaaaaaaaaaaaaaaaaaaaaakakakaaaaaaaaaaaaaaaaakakakaaaaaaaaaaaaaaaaaaaaaaaaaaaaaaaaaaaaaaaaaaaaaaaaaaaaaaaaaaaaaaaaaaaaaaaaaaaaaaaaaaaaaaaaaaaaaaaaahahahahahahahahahahahahahah
ababababaaaaaaaaaaaaaaaaaaaaaaaaaaaaaaaaaaaaaaakakakakaaaaaaaaaaaaaaaaaaakakaaaaaaaaaaaaaaaaaaaaaaaaaaaaaaaaaaaaaaaaaaaaaaaaaaaaaaaaaaaaaaaaaaaaaaaaaaaaaaaaaaaaaaaaaaaaaaaaaaaaaaaaahahahahahahahahahah
abababaaaaaaaaaaaaaaaaaaaaaaaaaaaaaaaaaaaaaaaaakakakakaaaaaHaaaaaaaaaaaaakakakaaaaaaaaaaaaaaaaaaaaaaaaaaaaaaaaaaaaaaaaaaaaaaaaaaaaaaaaaaaaaaaaaaaaaaaaaaaaaaaaaaaaaaaaaaaaaaaaaaaaaaaaahahahahahahahahah
ababaaaaaaaaaaaaaaaaaaaaaaaaaaaaaaaaaaaaaaaaaaakakaaaaaaaaaaaaaaaaaaaaaaaaakakaaaaaaaaaaaaaaaaaaaaaaaaaaaaaaaaaaaaaaaaaaaaaaaaaaaaaaaaaaaaaaaaaaaaaaaaaaaaaaaaaaaaaaaaaaaaaaaaaaaaaaaaaaaaaaahahahahahah
abaaaaaaaaaaaaaaaaaaaaaaaaaaaaaaaaaaaaaaaaaaaaakakaaaaaaaaaaaaaaaaaaaaaaaaakakaaaaaaaaaaaaaaaaaaaaaaaaaaaaaaaaaaaaaaaaaaaaaaaaaaaaaaaaaaaaaaaaaaaaaaaaaaaaaaaaaaaaaaaaaaaaaaaaaaaaaaaaaaaaaaaaahahahahah
aaaaaaaaaaaaaaaaaaaaaaaaaaaaaaaaaaaaaaaaaaaaaaakakaaaaaaaaaaaaaaaaaaaaaaaaaaakakaaaaaaaaaaaaaaaaaaaaaaaaaaaaaaaaaaaaaaaaaaaaaaaaaaaaaaaaaaaaaaaaaaaaaaaaaaaaaaaaaaaaaaaaaaaaaaaaaaaaaaaaaaaaaaaaaaahahah
aaaaaaaaaaaaaaaaaaaaaaaaaaaaaaaaaaaaaaaaaaaaaaakakaaaaaaaaaaaaaaaaaaaaaaaaaaakakakaaaaaaaaaaaaaaaaaaaaaaaaaaaaaaaaaaaaaaaaaaaaaaataaaaaaaaaaaaaaaaaaaaaaaaaaaaaaaIaaaaaaaaaaaaaaaaaaaaaaaaaaaaaaaaaaaaaa
aaaaaaaaaaaaaaaaaaaaaaaaaaaaaaaaaaaaaaaaaaaaakakakaaaaaaaaaaaaaaaaaaaaaaaaaaaaakakaaaaaaaaaaaaaaaaaaaaaaaaaaaaaaaaaaaaaaaaaaaaaaaaaaaaaaaaaaaaaaaaaaaaaaaaaaaaaaaaaaaaaaaaaaaaaaaaaaaaaaaaaaaaaaaaaaaaaa
aaaaaaaaaaaaaaaaaaaaaaaaaaaaaaaaaaaaaaaaaaaaakakakaaaaaaaaaaaaaaaaaaaaaaaaaaaaakakaaaaaaaaaaaaaaaaaaaaaaaaaaaaaaaaaaaaaaaaaaaaaaaaaaaaaaaaaaaaaaaaaaaaaaaaaaaaaaaaaaaaaaaaaaaaaaaaaaaaaaaaaaaaaaaaaaaaaa
aaaaaaaaaaaaaaaaaaaaaaaaaaaaaaaaaaaaaaaaaaaaakakaaaaaaaaaaaaaaaaaaaaaaaaaaaaaaaaakakaaaaaaaaaaaaaaaaaaaaaaaaaaaaaaaaaaaaaaaaaaaaaaaaaaaaaaaaaaaaaaauaaaaaaaaaaaaaaaaaaaaaaaaaaaaaaaaaaaaaaaaaaaaaaaaaaaa
aaaaaaaaaaaaaaaaaaaaaaaaaaaaaaaaaaaaaaaaaaaaakakaaaaaaaaaaaaaaaaaaaaaaaaaaaaaaaaaaaaakaaaaaaaaaaaaaaaaaaaaaaaaaaaaaaaaaaaaaaaaaaaaaaaaaaaaaaaaaaaaaaaaaaaaaaaaaaaaaaaaaaaaaaaaaaaaaaaaaaaaaaaaaaaaaaaaaa
aaaaaaaaaaaaaaaaaaaaaaaaaaaaaaaaaaaaaaaaaaaaakakaaaaaaaaaaaaaaaaaaaaaaaaaaaaaaaaaaaaaaaaaaaaaaaaaaaaaaaaaaaaaaaaaaaaaaaaaaaaaaaaaaaaaaaaaaaaaaaaaaaaaaaaaaaaaaaaaaaaaaaJaaaaaaaaaaaaaaaaaaaaaaaaaaaaaaaa
aaaaaaaaaaaaaaaaaaaaaaaaaaaaaaaaaaaaaaaaaaaaakakaaaaaaaaaaaaaaaaaaaaaaaaaaaaababababababaKabaaaaaaaaaaaaaaaaaaaaaaaaaaaaaaaaaaaaaaaaaaaaaaaaaaaaaaaaaaaaaaaaaaaaaaaaaaaaaaaaaaaaaaaaaaaaaaaaaaaaaaaaaaaa
aaaaaaaaaaaaaaaaaaaaaaaaaaaaaaaaaaaaaaaaaaaaakakaaaaaaaaaaabaaaaaaaaaaaaaaaLabababababababababaaaaaaaaaaaaaaaaaaaaaaaaaaaaaaaaaaaaaaaaaaaaaaaaaaaaaaaaaaaaaaaaaaaaaaaaaaaaaaaaaaaaaaaIaaaaaaaaaaaaaaaaaa
aaaaaaaaaaaaaaaaaaaaaaaaaaaaaaaaaaaaaaaaaaaaakakaaaaaaaaaaaMababababaaaaabababababababababababababaaaaaaaaaaaaaaaaaaaaaaaaaaaaaaaaaaaaaaaaaaaaaaaaaaaaaaaaaaaaaaaaaaaaaaaaaaaaaaaaaaaaaaaaaaaaaaaaaaaaaa
aaaaaaaaaaaaaaaaaaaaaaaaaaaaaaaaaaaaaaaaaaakakakaaaaaaaaaaaaabababababababababababaNababababababaOaaaaaaaaaaaaaaaaaaaaaaaaaaaaaaaaaaaaaaaaaaaaaaaaaaaaaaaaaaaaaaaaaaaaaaaaaaaaaaaaaaaaaaaaaaaaaaaaaaaaaa
aaaaaaaaaaaaaaaaaaaaaaaaaaaaaaaaaaaaaaaaaaakakakaaaaaaaaaaabababababababababababababababababababaaaaaaaaaaaaaaaaaaaaaaaaaaaiaaaaaaaaaaaaaaaaaaaaaaaaaaaaaJaaaaaaaaaaaaaaaaaaaaaaaaaaaaaaaaaaaaaaaaaaaaaa
aaaaaaaaaaaaaaaaaaaaaaaaaaaaaaaaaaaaaaaaaaakakaaaaaaaaaaaaababababababababababababababababaPabaaaaaaaaaaaaaaaaaaaaaaaaaaaiaiaiaaaaaaaaaaaaaaaaaaaaaaaaaaaaaaaaaaaaaaaaaaaaaaaaaaaaaaaaaaaaaaaaaaaaaaaaaa
aaaaaaaaaaaaaaaaaaaaaaaaaaaaaaaaaaaaaaaaaaakakaaaaaaaaaaaaaaababaQababababababababababaaababaaaaaaaaaaaaaaaaaaaaaaaaaiaiaiaiaiaiaaaaaaaaaaaaaaaaaaaaaaaaaaaaaaaaaaaaaaaaaaaaaaaaaaaaaaaaaaaaaaaaaaaaaaaa
aaaaaaaaaaaaaaaaaaaaaaaaaaaaaaaaaaaaaaaaaaakakaaaaaaaaaaaaaaaaababababababababababababaaaaaaaaaaaaaaaaaaaaaaaaaaaiaiaiaiavaiaiaiaiaaaaaaaaaaaaaaaaaaaaaaaaaaaaaaaaaaaaaaaaaaaaaaaaaaaaaaaaaaaaaaaaaaaaaa
aaaaaaaaaaaaaaaaaaaaaaaaaaaaaaaaaaaaaaaaaaakakaaaaaaaaaaaaaaaaaaababababababaRababababababaaaaaaaaaaaaaaaaaaaaaiawaiaiaiaiaiaiaiaiaaaaaaaaaaaaaaaaaaaaaaaaaaaaaaaaaaaaaaaaaaaaaaaaaaaaaaaaaaaaaaaaaaaaai
aaaaaaaaaaaaaaaaaaaaaaaaaaaaaaaaaaaaaaaaaaakakaaaaaaaaaaaaaaaaaaaaabababaaaaababababaSabababaaaaaaaaaaaaaaaaaaaiaiaqaiaiaraiaiaiaiaiaaaaaaaaaaaaaaaaaaaaaaaaaaaaaaaaaaaaaaaaaaaaaaaaaaaaaaaaaaaaaaaiaiai
aaaaaaaaaaaaaaaaaaaaaaaaaaaaaaaaaaaaaaaaaaakakaaaaaaaaaaaaaaaaaaaaababababaaabababababababababaaaaaaaaaaaaaaaaaaaiaiaiaiaiaiaiaiaiaiaaaaaaaaaaaaaaaaaaaaaaaaaaaaaaaaaaaaaaaaaaaaaaaaaaaaaaaaaiaiaiaiaiai
aaaaaaaaaaaaabababababaaaaaaaaaaaaaaaaaaaaakakaaaaaaaaaaaaaaaaaaaaaaaTababababababababaaabaUabaaaaaaaaaaaaaaaaaaaaaiaiaiaiaiaiaiaiaiaaaaaaaaaaaaaaaaaaaaaaaaaaaaaaaaaaaaaaaaaaaaaaaaaaaiaiaiaiaiaiaiaiai
aaaaaaaaababababababaaaaaaaaaaaaaaaaaaaaakakaaaaaaaaaaaaaaaaaaaaaaaaaaababababaaabaaabaaaaaaaaaaaaaaaaaaaaaaaaaaaaaiaiaiaiaiaiaaaaaaaaaaaaaaaaaaaaaaaaaaaaaaaaaaaaaaaaaaaaaaaaaaaaaiaiaiaiaiaiaiaiaiaiai
aaaaaaababababababaaaaabababaaaaaaaaaaaaakakaaaaaaaaaaaaaaaaaaaaaaaaaaaaabababaaaaaaaaaaaaaaaaaaaaaaaaaaaaaaaaaaaaaiaiaiaiaiaaaaaaaaaaaaaaaaaaaaaaaaaaaaaaaaaaaaaaaaaaaaaaaaaaaaaiaiaiaiaiaiaiaiaiaiaiai
aaaaabababababababaaabababaaaaaaaaaaaaaaakakaaaaaaaaaaaaagaaaaaaaaaaaaaaaaaaaaaaaaaaaaaaaaaaaaaaaaaaaaaaaaaaaaaaaaaaaaaaaaaaaaaaaaaaaaaaaaaaaaaaaaaaaaaaaaaaaaaaaaaaaaaaaaaaaaaiaiaiaiaiaiaiaiaiaiaiaiai
aaaaabababababababababababaaaaaaaaaaaaaaakakaaaaaaaaaaaaagaaaaaaaaaaaaaaaaaaaaaaaaaaaaaaaaaaaaaaaaaaaaaaaaaaaaaaaaaaaaaaaaaaaaaaaaaaaaaaaaaaaaaaaaaaaaaaaaaaaaaaaaaaaaaaaaaiaiaiaiaiaiaiaiaiaiaiaiaiaiai
aaaaabababababababababababaaaaaaaaaaaaaaakakaaaaaaaaaaaaaaaaaaaaaaaaaaaaaaaaaaaaaaaaaaaaaaaaaaaaaaaaaaaaaaaaaaaaaaaaaaaaaaaaaaaaaaaaaaaaaaaaaaaaaaaaaaaaaaaaaaaaaaaaaaaaaiaiaiaiaiaiaiaiaiaiaiaiaiaiaiai
aaaaababababababababababaaaaaaaaaaaaaaakakakaaaaaaaaaaaaaaagaaaaaaaaaaaaaaaaaaaaaaaaaaaaaaaaaaaaaaaaaaaaaaaaaaaaaaaaaaaaaaaaaaaaaaaaaaaaaaaaaaaaaaaaaaaaaaaaaaaaaaaaaiaiaiaiaiaiaiaiaiaiaiaxaiaiaiaiaiai
aaaaaaaaababababababababaaaaaaaaaaaaaaakakaaaaaaaaaaaaaaagagaaaaaaaaaaaaaaaaaaaaaaaaaaaaaaaaaaaaaaayaaaaaaaaaaaaaaaaaaaaaaaaazaaaaaaaaaaaaaaaaaaaaaaaaaaaaaaaaaaaaaaaiaiaiaiaiaiaiaiaiaiaiaiaiaiaiaiaiai
aaaaaaaaabababababababaaaaaaaaaaaaaaaaakakaaagagagagagagagagaaaaaaaaaaaaaaaaaaaaaaaaaaaaaaaaaaaaaaaaaaaaaaaAaaaaaaaaaaaaaaaaaaaaaaaaaaaaaaaaaaaaaaaaaaaaaaaaaaaaaaaiaiaiaiaiaiaiaiaiaiaiaiaiaiaiaiaiaiai
aaaaaaababababababaaaaaaaaaaaaaaaaaaaaakakaaaaaaagagagagagagaaaaaaaaaaaaaaaaaaaaaaaaaaaaaaaaaaaaaaaaaaaaaaaaaaaaaaaaaaaaaaaaaaaaaaaaaaaaaaaaaaaaaaaaaaaaaaaaaaaiaiaiaiaiaiaiaiaiaiaiaiaiaiaBaiaiaiaiaiai
aaaaabababaaaaaaabaaaaaaaaaaaaaaaaaaaaakakaaaaaaaaaaaaaaagagaaaaaaaaaaaaaaaaaaaaaaaaaaaaaaaaaaaaaaaaaaaaaaaaaaaaaaaaaaaaaaaaaaaaaaaaaaaaaaaaaaaaaaaaaaaaaaaaaiaiaiaiaiaiaiaiaiaiaiaiaCaiaiaiaiaiaiaiaiai
aaaaaaabaaaaaaaaaaaaaaaaaaaaaaaaaaaaaaakakaaaaaaaaaaaaaaagagaaaaaaaaaaaaaaaaaaaaaaaaaaaaaaaaaaaaaaaaaaaaaaaaaaaaaaaaaaaaaaaaaaaaaaaaaaaaaaaaaaaaaaaaaaaaaaaiaiaiaiaiaiaiaiaiaiaiaiaiaiaiaiaiaiaiaiaiaiai
aaaaaaaaaaaaaaaaaaaaaaaaaaaaaaaaaaaaaaakakaaaaaaaaaaaaaaagagaaaaaaaaaaaaaaaaaaaaaaaaaaaaaaaaaaaaaaaaaaaaaaaaaaaaaaaaaaaaaaaaaaaaaaaaaaaaaaaaaaaaaaaaaaaaaaaiaiaiaiaiaiaiaiaiaiaiaiaiaiaiaiaiaiaiaiaiaiai
aaaaaaaaaaaaaaaaaaaaaaaaaaaaaaaaaaaaaaakakaaaaaaaaaaaaaaagagaaaaaaaaaaaaaaaaaaaaaaaaaaaaaaaaaaaaaaaaaaaaaaaaaaaaaaaaaaayaaaaaaaaaaaaaaaaaaaaaaaaaaaaaaaiaiaiaiaiaiaiaiaiaiaiaiaiaiaiaiaiaiaiaiaiaiaiaiai
aaaaaaaaaaaaaaaaaaaaaaaaaaaaaaaaaaaaaaakakaaaaaaaaaaaaaaagagaaaaaaaaaaaaaaaaaaaaaaaaaaaaaaaaaaaaaaaaaaaaaaaaaaaaaaaaaaaaaaaaaaaaaaaaaaaaaaaaaaaaaaaaaiaiaiaiaiaiaiaiaiaiaiaiaiaiaiaiaiaiaiaiaiaiaiaiaiai
aaaaaaaaaaaaaaaaaaaaaaaaaaaaaaaaaaaaaaakakaaaaaaaaaaaaaaagagaaaaaaaaaaaaaaaaaaaaaaaaaaaaaaaAaaaaaaaaaaaaaaaaaaaaaaaaaaaaaaaaaaaaaaaaaaaaaaaaaaaaaaaiaiaiaiaiaiaiaiaiaiaiaiaiaiaiaiaiaiaiaiaiaiaiaiaiaiai
aaaaaaaaaaaaaaaaaaaaaaaaaaaaaaaaaaaaaaakakaaaaaaaaaaaaaaagagaaaaaaaaaaaaaaaaaaaaaaaaaaaaaaaaaaaaaaaaaaaaaaaaaaaaaaaaaaaaaaaaaaaaaaaaaaaaaaaaaaaaaiaiaiaiaiaiaiaiaiaiaiaiaiaiaiaiaiaiaiaiaiaiaiaiaiaiaiai
aaaaaaaaaaaaaaaaaaaaaaaaaaaaaaaaaaaaakakakaaaaaaaaaaaaaaagagaaaaaaaaaaaaaaaaaaaaaaaaaaaaaaaaaaaaaaaaaaaaaaaaaaaaaaaaaaaaaaaaaaaaaaaaaaaaaaaaaiaiaiaiaiaiaiaiaiaVaiaiaiaiaiaiaiaiaiaiaiaiaiaiaiaiaiaiaiai
aaaaaaaaaaaaaaaaaaaaaaaaaaaaaaaaaaaaakakaaaaaaaaaaaaaaaaagagagagagagagagagaaagagaaaaaaaaaaaaaaaaaaaaaaaaaaaaaaaaaaaaaaaaaaaaaaaaaaaaaaaaaaaiaiaiaiaiaiaiaiaiaiaiaiaiaiaiaiaiaiaiaiaiaiaiaiaiaiaiaiaiaiai
aaaaaaaaaaaaaaaaaaaaaaaaaWaaaaaaaaaaakalaaaaaaaaaaaaaaaaagagagagagagagagagagaaagagaaaaaaaaaaaaaaaaaaaaaaaaaaaaaaaaaaaaaaaaaaaaaaaaaaaaaaaiaiaiaiaiaiaiaiaiaiaiaiaiaiaiaiaiaiaiaiaiaiaiaiaiaiaiaiaiaiaiai
aaaaaaaaaaaaaaaaaaaaaaaaaaaaaaaaaaaaakakaaaaaaaaaaaaaaagagagaaaaaaaaaaaaaaaaaaaaaaaaaaaaaaaaaaaaaaaaaaaaaaaaaaaaaaaaaaaaaaaaaaaaaaaaaaaiaiaiaiaiaiaiaiaiaiaiaiaiaiaiaiaiaiaiaiaiaiaiaiaiaiaiaiaiaiaiaiai
aaaaaaaaaaaaaaaaaaaaaaaaaaaaaaaaaaaaakakaaaaaaaaaaaaagagagagaaaaaaaaaaaaaaaaaaaaaaaaaaaaaaaaaaaaaaaaaaaaaaaaaaaaaaaaaaaaaaaaaaaaaaaaaiaiaiaiaiaiaiaiaiaiaiaiaiaiaiaiaiaiaiaiaiaiaiaiaiaiaiaiaiaiaiaiaiai
aaaaaaaaaXaaaaaaaaaaaaaaaaaaaaaaaaaaakakaaaaaaaaaaagagagagaaaaaaaaaaaaaaaaaaaaaaaaaaaaaaaaaaaaaaaaaaaaaaaaaaaaaaaaaaaaaaaaaaaaaaaaaiaiaiaiaiaiaiaiaiaiaiaiaiaiaiaiaiaiaiaiaiaiaiaiaiaiaiaiaiaiaiaiaiaiai
aaaaaaaaaaaaaaaaaaaYaaaaaaaaaaaaaaaaakakaaaaaaagagagaaaaaaaaaaaaaaaaaaaaaaaaaaaaaaaaaaaaaaaaaaaaaaaaaaaaaaaaaaaaaaaaaaaaaaaaaaaaaiaiaiaiaiaiaiaiaiaiaiaiaiaiaiaiaiaiaiaiaiaiaiaiaiaiaiaiaiaiaiaiaiaiaiai
aaaaaaaaaaaaaaaaaaafafaaafafaaaaaZaaakakaaaaaaagagagaaaaaaaaaaaaaaaaaaaaaaaaaaaaaaaaaaaaaaaaaaaaaaaaaaaaaaaaaaaaaaaaaaaaaaaaaaaiaiaiaiaiaiaiaiaiaiaiaiaiaiaiaiaiaiaiaiaiaiaiaiaiaiaiaiaiaiaiaiaiaiaiaiai
aaaaaaaaaaaaafafafafafafafafaaaaaaaaakakaaaaaaagagaaaaaaaaaaaaaaaaaaaaaaaaaaaaaaaaaaaaaaaaaaaaaaaaaaaaaaaaaaaaaaaaaaaaaaaaaaaiaiaiaiaiaiaiaiaiaiaiaiaiaiaiaiaiaiaiaiaiaiaiaiaiaiaiaiaiaiaiaiaiaiaiaiaiai
aaaaaaaaaaaaaaafafafafaaaaaaaaaaaaaaakakaaaaagagaaaaaaaaaaaaaaaaaaaaaaaaaaaaaaaaaaaaaaaaaaaaaaaaaaaaaaaaaaaaaaaaaaaaaaaaaaaiaiaiaiaiaiaiaiaiaiaiaiaiaiaiaiaiaiaiaiaiaiaiaiaiaiaiaiaiaiaiaiaiaiaDaiaiaiai
aaaaaaaaaaaaaaafafaaaaaaaaaaaaaaaaaaakakaaaaaaaaaaaaaaaaaaaaaaaaaaaaaaaaaaaaaaaaaaaaaaaaaaaaaaaaaaaaaaaaaaaaaaaaaaaaaaaaaiaiaiaoaiaiaiaiaiaiaiaiaiaiaiaiaiaiaiaiaiaiaiaiaiaibaaiaiaiaiaiaiaiaiaiaiaiaiai
aaaaaaaaaaaaaaaaaaaaaaaaaaaaaaaaaaaaakakaaaaaaaaaaaaaaaaaaaaaaaaaaaaaaaaaaaaaaaaaaaaaaaaaaaaaaaaaaaaaaaaaaaaaaaaaaaaaaaiaiaiaiaiaiaiaiaiaiaiaiaiaiaiaiaiaiaiaiaiaiaiaiaiaiaiaiaiaiaiaiaiaiaiaiaiaiaiaiai
aaaaaaafaaaaaaaaaaaaaaaaaaaaaaaaaaaaakakaaaaaaaaaaaaaaaaaaaaaaaaaaaaaaaaaaaaaaaaaaaaaaaaaaaaaaaaaaaaaaaaaaaaaaaaaaaaaiaiaiaiaiaiaiaiaiaiaiaiaiaiaiaiaiaiaiaiaiaiaiaiaiaiaiaiaiaiaiaiaiaiaiaiaiaiaiaiaiai
aaaaaaafafaaafafafafafafaaaaaaaaaaaaakakaaaaaaaaaaaaaaaaaaaaaaaaaaaaaaaaaaaaaaaaaaaaaaaaaaaaaaaaaaaaaaaaaaaaaaaaaaaiaiaiaiaiaiaiaiaiaiaiaiaiaiaiaiaiaiaiaiaiaiaiaiaiaiaiaiaiaiaiaiaibbaiaiaiaiaiaiaiaiai
aaaaaaafafaaafafafafafafaaaaaaaaaaaaakakaaaaaaaaaaaaaaaaaaaaaaaaaaaaaaaaaaaaaaaaaaaaaaaaaaaaaaaaaaaaaaaaaaaaaaaaaiaiaiaiaiaiaiaiaiaiaiaiaiaiaiaiaiaiaiaiaiaiaiaiaiaiaiaiaiaiaiaiaiaiaiaiaiaiaiaiaiaiaiai
aaaaaaafafafafafafaaaaaaaaaaaaaaaaaaakamaaaaaaaaaaaaaaaaaaaaaaaaaaaaaaaaaaaaaaaaaaaaaaaaaaaaaaaaaaaaaaaaaiaiaiaiaiaiaiaiaiaiaiaiaiaiaiaiaiaiaiaiaiaiaiaiaiaiaiaiaiaiaiaiaiaiaiaiaiaiaiaiaiaiaiaiaiaiaiai
aaaaaaafafafafafafafafaaaaaaaaaaaaaaakakaaaaaaaaaaaaaaaaaaaaaaaaaaaaaaaaaaaaaaaaaaaaaaaaaaaaaaaaaaaaaiaiaiaiaiaiaiaiaiaiaiaiaiaiaiaiaiaiaiaiaiaiaiaiaiaiaiaiaiaiaiaiaEaiaiaiaiaiaiaiaiaiaiaiaiaiaiaiaiai
aaaaaaafafaaaaafafafaeaaaaaaaaaaaaaaakakaaaaaaaaaaaaaaaaaaaaaaaaaaaaaaaaaaaaaaaaaaaaaaaaaaaaaaaaaaaiaiaiaiaiaiaiaiaiaiaiaiaiaiaiaiaiaiaiaiaiaiaiaiaiaiaiaiaiaiaiaiaiaiaiaiaiaiaiaiaiaiaiaiaiaiaiaiaiaiai
aaaaaaaaaaaaaaafafaaaaaaaaaaaaaaaaaaakakaaaaaaaaaaaaaaaaaaaaaaaaaaaaaaaaaaaaaaaaaaaaaaaaaaaaaaaiaiaiaiaiaiaiaiaiaiaiaiaiaiaiaiaiaiaiaiaiaiaiaiaiaiaiaiaiaiaiaiaiaiaiaiaiaiaiaiaiaiaiaiaiaiaiaiaiaiaiaiai
aaaaaaaaaaaaafafafafaaaaafafafaaaaaaakakaaaaaaaaaaaaaaaaaaaaaaaaaaaaaaaaaaaaaaaaaaaaaaaaaaaaaaaiaiaiaiaiaiaiaiaiaiaiaiaiaiaiaiaiaiaiaiaiaiaiaiaiaiaiaiaiaiaiaiaiaiaFaiaiaiaiaiaiaiaiaiaiaiaiaiaiaiaiaiai
aaaaaaaaaaaaaaafafafafafafafaaaaaaaaakakaaaaaeaaaaaaaaaaaaaaaaaaaaaaaaaaaaaaaaaaaaaaaaaaaaaaaiaiaiaiaiaiaibaaiaiaiaiaiaiaiaiaiaiaiaiaiaiaiaiaiaiaiaiaiaiaiaiaiaiaiaiaiaiaiaiaiaiaiaiaiaiaiaiaiaiaiaiaiai
abaaaaaaaaafafafafafafafafaaaaaaaaaaakakaaaaaaaaaaaaaaaaaaaaaaaaaaaaaaaaaaaaaaaaaaaaaaaaaaaiaiaiaiaiaiaiaiaiaiaiaiaiaiaiaiaiaiaiaiaiaiaiaiaiaiaiaiaiaFaiaiaiaiaiaiaiaiaiaiaiaiaiaiaiaiaiaiaiaiaiaiaiaiai
abaaaaaaaaafafafafafafaaaaaaaaaaaaaaakakaaaaaaaaaaaaaaaaaaaaaaaaaaaaaaaaaaaaaaaaaaaaaaaaaaaiaiaiaiaiaiaiaiaiaiaiaiaiaiaiaiaiaiaiaibcaiaiaiaiaiaiaiaiaiaiaiaiaiaiaiaiaiaiaiaiaiaiaiaiaiaiasaiaiaiaiaiaiai
abaaaaaaaaaaafafafafaaaaaaaaaaaaaaaaakakaaaaaaaaaaaaaaaaaaaaaaaaaaaaaaaaaaaaaaaaaaaaaaaaaaaiaiaiaibbaiaiaiaiaiaiaiaiaiaiaiaiaiaiaiaiaiaiaiaiaiaiaiaiaiaiaiaiaiaiaiaiaiaiaiaiaiaiaiaiaiaiaiaiaiaiaiaiaiai
abaaaaaaaaaaaaaaaaaaaaaaaaaaaaaaaaaaakakaaaaaaaaaaaaaaaaaaaaaaaaaaaaaaaaaaaaaaaaaaaaaaaaaaaiaiaiaiaiaiaiaiaiaiaiaiaiaiaiaiaiaiaiaiaiaiaiaiaiaiaiaiaiaiaiaiaiaiaiaiaiaiaiaiaiaiaiaiaiaiaiaiaiaiaiaiaiaiai
ababaaaaaaaaaaaaaaaaaaaaaaaaaaaaaaaaakakaaaaaaaaaaaaaaaaaaaaaaaaaaaaaaaaaaaaaaaaaaaaaaaaaiaiaiaiaiaiaiaiaiaiaiaiaiaiaiaiaiaiaiaiaiaiaiaiaiaiaiaiaiaiaiaiaiaiaiaiaiaiaiaiaiaiaiaiaiaiaiaiaiaiaiaiaiaiaiai
ababababaaaaaaaaaaaaaaaaaaaaaaaaaaaaakakaaaaaaaaaaaaaaaaaaaaaaaaaaaaaaaaaaaaaaaaaaaaaaaiaiaiaiaiaiaiaiaiaiaiaiaibaaiaiaiaiaiaiaiaiaiaiaiaiaiaiaiaiaiaiaiaiaiaiaiaiaiaiaiaiaiaiaiaiaiaiaiaiaiaiaiaiaiaiai
abababababababababaaaaaaaaaaaaaaaaaaakakaaaaaaaaaaaaaaaaaaaaaaaaaaaaaaaaaaaaaaaaaaaaaiaiaiaiaiaiaiaGaiaiaiaiaiaiaiaiaiaiaiaiaiaiaiaiaiaiaiaiaiaiaiaiaiaiaiaiaiaiaiaiaiaiaiaiaiaiaiaiaiaiaiaiaiaiaiaiaiai
abababababababababababababaaaaaaaaakakakaaaaaaaaaaaaaaaaaaaaaaaaaaaaaaaaaaaaaaaaaaaaaiaiaVaiaiaiaiaiaiaiaiaiaiaiaiaiaiaiaiaiaiaiaiaiaiaiaiaiaiaiaiaiaiaiaiaiaiaiaiaiaiaiaiaiaiaiaiaiaiaiaiaiaiaiaiaiaiai
"}
