"a" = (/turf/water,/area)
"b" = (/turf/dirt,/area)
"c" = (/turf/dgrass,/area)
"d" = (/turf/grass,/area)
"e" = (/turf/sand,/area)
"f" = (/turf/gravel,/area)
"g" = (/turf/Lgrass,/area)
"h" = (/turf/beach,/area)
"i" = (/obj/overworld/kamehouse{step_x = -14},/turf/grass,/area)
"j" = (/obj/overworld/lookout,/turf/Lgrass,/area)
"k" = (/obj/overworld/krillin_training,/turf/beach,/area)
"l" = (/obj/overworld/cellgames,/turf/dgrass,/area)
"m" = (/obj/overworld/city,/turf/dgrass,/area)
"n" = (/obj/overworld/pod,/turf/dgrass,/area)
"o" = (/obj/Rock/Rock5,/turf/dgrass,/area)
"p" = (/turf_overlays/rocks/rock6,/turf/dgrass,/area)
"q" = (/turf_overlays/rocks/rock4,/turf/dgrass,/area)
"r" = (/obj/Rock/Rock1,/turf/dirt,/area)
"s" = (/obj/overworld/ccpod,/turf/dgrass,/area)
"t" = (/obj/Rock/Rock6,/turf/dgrass,/area)
"u" = (/obj/overworld/city,/turf/grass,/area)
"v" = (/obj/overworld/budokai,/turf/grass,/area)
"w" = (/obj/overworld/tien_training,/turf/dgrass,/area)
"x" = (/obj/overworld/cell_training,/turf/dgrass,/area)
"y" = (/obj/overworld/piccolo_training,/turf/dgrass,/area)
"z" = (/obj/overworld/trunks_training,/turf/dgrass,/area)
"A" = (/obj/overworld/raditz_training,/turf/dgrass,/area)
"B" = (/obj/Rock/Rock6,/turf/grass,/area)
"C" = (/obj/Rock/Rock5,/turf/grass,/area)
"D" = (/obj/overworld/vegeta_training,/turf/grass,/area)
"E" = (/obj/overworld/yamcha_training,/turf/sand,/area)
"F" = (/obj/overworld/nappa_training,/turf/grass,/area)
"G" = (/obj/overworld/redribbonbase,/turf/gravel,/area)
"H" = (/obj/overworld/capsulecorp,/turf/grass,/area)
"I" = (/obj/overworld/pilafscastle,/turf/sand,/area)
"J" = (/obj/overworld/gokushouse,/turf/grass,/area)
"K" = (/obj/overworld/grandpagohans,/turf/grass,/area)
"L" = (/obj/overworld/yamchahideout,/turf/sand,/area)
"M" = (/obj/overworld/baba,/turf/sand,/area)
"N" = (/obj/overworldstart,/turf/grass,/area)
"O" = (/obj/overworld/gohan_training,/turf/grass,/area)
"P" = (/obj/overworld/goku_training,/turf/grass,/area)
"Q" = (/obj/overworld/chaiotzu_training,/turf/dirt,/area)
"R" = (/turf/blank,/area)
"S" = (/obj/overworld/roshi_training,/turf/sand,/area)
"T" = (/obj/overworld/satan_training,/turf/grass,/area)

(1,1,1) = {"
Raaaaaaaaaaaaaaaaaaaaaaaaaaaaaaaaaaaaaaaaaaaaaaaaaaaaaaaaaaaaaaaaaaaaaaaaaaaaaaaaaaaaaaaaaaaaaaaaaaa
Raaaaaaaaaaaaaaaaaaaaaaaaaaaaaaaaaaaaaaaaaaaaaaaaaaaaaaaaaaaaaaaaaaaaaaaaaaaaaaaaaaaaaaaaaaaaaaaaaaa
Raaaaaaaaaaaaaaaaaaaaaaaaaaaaaaaaaaaaaaaaaaaaaaaaaaaaaaaaaaaaaaaaaaaaaaaaaaaaaaaaaaaaaaaaaaaaaaaaaaa
Raaaaaaaaaaaaaaaaaaaaaaaaaaaaaaaaaaaaaaaaaaaaaaaaaaaaaaaaaaaaaaaaaaaaaaaaaaaaaaaaaaaaaaaaaaaaaaaaaaa
Raaaaaaaaaaaaaaaaaaaaaaaaaaaaaaaaaaaaaaaaaaaaaaaaaaaaaaaaaaaaaaaaaaaaaaaaaaaaaaaaaaaaaaaaaaaaaaaaaaa
Raaaaaaaaaaaaaaaaaaaaaaaaaaaaaaaaaaaaaaaaaaaaaaaaaaaaaaaaaaaaaaaaaaaaaaaaaaaaaaaaaaaaaaaaaaaaaaaaaaa
Raaaaaaaaaaaaaaaaaaaaaaaaaaaaaaaaaaaaaaaaaaaaaaaaaaaaaaaaaaaaaaaaaaaaaaaaaaaaaaaaaaaaaaaaaaaaaaaaaaa
Raaaaaaaaaaaaaaaaaaaaaaaaaaaaaaaaaaaaaaaaaaaaaaaaaaaaaaaaaaaaaaaaaaaaaaaaaaaaaaaaaaaaaaaaaaaaaaaaaaa
Raaaaaaaaaaaaaaaaaaaaaaaaaaaaaaaaaaaaaaaaaaaaaaaaaaaaaaaaaaaaaaaaaaaaaaaaaaaaaaaaaaaaaaaaaaaaaaaaaaa
Raaaaaaaaaaaaaaaaaaaaaaaaaaaaaaaaaaaaaaaaaaaaaaaaaaaaaaaaaaaaaaaaaaaaaaaaaaaaaaaaaaaaaaaaaaaaaaaaaaa
Raaaaaaaaaaaaaaaaaaaaaaaaaaaaaaaaaaaaaaaaaaaaaaaaaaaaaaaaaaaaaaaaaaaaaaaaaaaaaaaaaaaaaaaaaaaaaaaaaaa
Raaaaaaaaaaaaaaaaaaaaaaaaaaaaaaaaaaaaaaaaaaaaaaaaaaaaaaaaaaaaaaaaaaaaaaaaaaaaaaaaaaaaaaaaaaaaaaaaaaa
Raaaaaaaaaaaaaaaaaaaaaaaaaaaaaaaaaaaaaaaaaaaaaaaaaaaaaaaaaaaaaaaaaaaaaaaaaaaaaaaaaaaaaaaaaaaaaaaaaaa
Raaaaaaaaaaaaaaaaaaaaaaaaaaaaaaaaaaaaaaaaaaaaaaaaaaaaaaaaaaaaaaaaaaaaaaaaaaaaaaaaaaaaaaaaaaaaaaaaaaa
Raaaaaaaaaaaaaaaaaaaaaaaaaaaaaaaaaaaaaaaaaaaaaaaaaaaaaaaaaaaaaaaaaaaaaaaaaaaaaaaaaaaaaaaaaaaaaaaaaaa
Raaaaaaaaaaaaaaaaaaaaaaaaaaaaaaaaaaaaaaaaaaaaaaaaaaaaaaaaaaaaaaaaaaaaaaaaaaaaaaaaaaaaaaaaaaaaaaaaaaa
Raaaaaaaaaaaaaaaaaaaaaaaaaaaaaaaaaaaaaaaaaaaaaaaaaaaaaaaaaaaaaaaaaaaaaaaaaaaaaaaaaaaaaaaaaaaaaaaaaaa
Raaaaaaaaaaaaaaaaaaaaaaaaaaaaaaaaaaaaaaaaaaaaaaaaaaaaaaaaaaaaaaaaaaaaaaaaaaaaaaaaaaaaaaaaaaaaaaaaaaa
Raaaaaaaaaaaaaaaaaaaaaaaaaaaaaaaaaaaaaaaaaaaaaaaaaaaaaaaaaaaaaaaaaaaaaaaaaaaaaaaaaaaaaaaaaaaaaaaaaaa
Raaaaaaaaaaaaaaaaaaaaaaaaaaaaaaaaaaaaaaaaaaaaaaaaaaaaaaaaaaaaaaaaaaaaaaaaaaaaaaaaaaaaaaaaaaaaaaaaaaa
Raaaaaaaaaaaaaaaaaaaaaaaaaaaaaaaaaaaaaaaaaaaaaaaaaaaaaaaaaaaaaaaaaaaaaaaaaaaaaaaaaaaaaaaaaaaaaaaaaaa
Raaaaaaaaaaaaaaaaaaaaaaaaaaaaaaaaaaaaaaaaaaaaaaaaaaaaaaaaaaaaaaaaaaaaaaaaaaaaaaaaaaaaaaaaaaaaaaaaaaa
Raaaaaaaaaaaaaaaaaaaaaaaaaaaaaaaaaaaaaaaaaaaaaaaaaaaaaaaaaaaaaaaaaaaaaaaaaaaaaaaaaaaaaaaaaaaaaaaaaaa
Raaaaaaaaaaaaaaaaaaaaaaaaaaaaaaaaaaaaaaaaaaaaaaaaaaaaaaaaaaaaaaaaaaaaaaaaaaaaaaaaaaaaaaaaaaaaaaaaaaa
Raaaaaaaaaaaaaaaaaaaaaaaaaaaaaaaaaaaaaaaaaaaaaaaaaaaaaaaaaaaaaaaaaaaaaaaaaaaaaaaaaaaaaaaaaaaaaaaaaaa
Raaaaaaaaaaaaaaaaaaaaaaaaaaaaaaaaaaaaaaaaaaaaaaaaaaaaaaaaaaaaaaaaaaaaaaaaaaaaaaaaaaaaaaaaaaaaaaaaaaa
Raaaaaaaaaaaaaaaaaaaaaaaaaaaaaaaaaaaaaaaaaaaaaaaaaaaaaaaaaaaaaaaaaaaaaaaaaaaaaaaaaaaaaaaaaaaaaaaaaaa
Raaaaaaaaaaaaaaaaaaaaaaaaaaaaaaaaaaaaaaaaaaaaaaaaaaaaaaaaaaaaaaaaaaaaaaaaaaaaaaaaaaaaaaaaaaaaaaaaaaa
Raaaaaaaaaaaaaaaaaaaaaaaaaaaaaaaaaaaaaaaaaaaaaaaaaaaaaaaaaaaaaaaaaaaaaaaaaaaaaaaaaaaaaaaaaaaaaaaaaaa
Raaaaaaaaaaaaaaaaaaaaaaaaaaaaaaaaaaaaaaaaaaaaaaaaaaaaaaaaaaaaaaaaaaaaaaaaaaaaaaaaaaaaaaaaaaaaaaaaaaa
Raaaaaaaaaaaaaaaaaaaaaaaaaaaaaaaaaaaaaaaaaaaaaaaaaaaaaaaaaaaaaaaaaaaaaaaaaaaaaaaaaaaaaaaaaaaaaaaaaaa
Raaaaaaaaaaaaaaaaaaaaaaaaaaaaaaaaaaaaaaaaaaaaaaaaaaaaaaaaaaaaaaaaaaaaaaaaaaaaaaaaaaaaaaaaaaaaaaaaaaa
Raaaaaaaaaaaaaaaaaaaaaaaaaaaaaaaaaaaaaaaaaaaaaaaaaaaaaaaaaaaaaaaaaaaaaaaaaaaaaaaaaaaaaaaaaaaaaaaaaaa
Raaaaaaaaaaaaaaaaaaaaaaaaaaaaaaaaaaaaaaaaaaaaaaaaaaaaaaaaaaaaaaaaaaaaaaaaaaaaaaaaaaaaaaaaaaaaaaaaaaa
Raaaaaaaaaaaaaaaaaaaaaaaaaaaaaaaaaaaaaaaaaaaaaaaaaaaaaaaaaaaaaaaaaaaaaaaaaaaaaaaaaaaaaaaaaaaaaaaaaaa
Raaaaaaaaaaaaaaaaaaaaaaaaaaaaaaaaaaaaaaaaaaaaaaaaaaaaaaaaaaaaaaaaaaaaaaaaaaaaaaaaaaaaaaaaaaaaaaaaaaa
Raaaaaaaaaaaaaaaaaaaaaaaaaaaaaaaaaaaaaaaaaaaaaaaaaaaaaaaaaaaaaaaaaaaaaaaaaaaaaaaaaaaaaaaaaaaaaaaaaaa
Raaaaaaaaaaaaaaaaaaaaaaaaaaaaaaaaaaaaaaaaaaaaaaaaaaaaaaaaaaaaaaaaaaaaaaaaaaaaaaaaaaaaaaaaaaaaaaaaaaa
Raaaaaaaaaaaaaaaaaaaaaaaaaaaaaaaaaaaaaaaaaaaaaaaaaaaaaaaaaaaaaaaaaaaaaaaaaaaaaaaaaaaaaaaaaaaaaaaaaaa
Raaaaaaaaaaaaaaaaaaaaaaaaaaaaaaaaaaaaaaaaaaaaaaaaaaaaaaaaaaaaaaaaaaaaaaaaaaaaaaaaaaaaaaaaaaaaaaaaaaa
Raaaaaaaaaaaaaaaaaaaaaaaaaaaaaaaaaaaaaaaaaaaaaaaaaaaaaaaaaaaaaaaaaaaaaaaaaaaaaaaaaaaaaaaaaaaaaaaaaaa
Raaaaaaaaaaaaaaaaaaaaaaaaaaaaaaaaaaaaaaaaaaaaaaaaaaaaaaaaaaaaaaaaaaaaaaaaaaaaaaaaaaaaaaaaaaaaaaaaaaa
Raaaaaaaaaaaaaaaaaaaaaaaaaaaaaaaaaaaaaaaaaaaaaaaaaaaaaaaaaaaaaaaaaaaaaaaaaaaaaaaaaaaaaaaaaaaaaaaaaaa
Raaaaaaaaaaaaaaaaaaaaaaaaaaaaaaaaaaaaaaaaaaaaaaaaaaaaaaaaaaaaaaaaaaaaaaaaaaaaaaaaaaaaaaaaaaaaaaaaaaa
Raaaaaaaaaaaaaaaaaaaaaaaaaaaaaaaaaaaaaaaaaaaaaaaaaaaaaaaaaaaaaaaaaaaaaaaaaaaaaaaaaaaaaaaaaaaaaaaaaaa
Raaaaaaaaaaaaaaaaaaaaaaaaaaaaaaaaaaaaaaaaaaaaaaaaaaaaaaaaaaaaaaaaaaaaaaaaaaaaaaaaaaaaaaaaaaaaaaaaaaa
Raaaaaaaaaaaaaaaaaaaaaaaaaaaaaaaaaaaaaaaaaaaaaaaaacccccccccccaaaaaaaaaaaaaaaaaaaaaaaaaaaaaaaaaaaaaaa
Raaaaaaabaabbabccaaaaaaaaaaaaaaaaaaaaaaaaaaaaaaaaccccccccccccccccmcffaaaaaaafffffaaaaaaaaaaaaaaaaaaa
Raaaaaabbbbbbbcccaaaaaaaaaaaaaaaaaaaaaaccccccccccccccccccccccccccccfffffffffffffffaaaaaaaaaaaaaaaaaa
Raaaaabbbbbbbbccccaaaaaaaaaaaaaaaccccccccccccccccccccccccccccccccccfffffffffffffffaaaaaaaaaaaaaaaaaa
RaaaaabbbbbbbQcwccaaaaaaaaaaaaaccccccccccccccccccccccccccccccccccccffffffffffGffffaaaaaaaaaaaaaaaaaa
Raaaaabbbbbbbccccaaaaaaaaaaaacccccccccccccccccccccccccccccccccccccccffffffffffffffaaaaaaaaaaaaaaaaaa
Raaaaabbbbbbccccaaaaaacccaaaccccccccccccccccccccccccccccccccccccccccfffffffffffffffaaaaaaaaaaaaaaaaa
Raaaaaaabbbcccaaaaaccccccccccccccccccccccccccccccclcccccccccccccccccffffffffffffffffaaaaaaaaaaaaaaaa
Raaaaaaaaabcaaaacccccccccccccccccccccccccccccccccccxcccccccccccccccccfffffffffffffffaaaaaaaaaaaaaaaa
Raaaaaaaaaaaaacccccccccccccccccccccccccccccccccccccccccccccccccccccccccfffffffffffaaaaaaaaaaaaaaaaaa
Raaaaaaaaaacccccccccccccccccccccccccccccccccccccccccccccccccccccccccccccffffffffffaaaaaaaaaaaaaaaaaa
Raaaaaaaaaccccccccccccccccccccccccccccccccmccccccccccccccccccccccycccccccffffffffcaaaaaaaaaaaaaaaaaa
Raaaaaaaaacccccccccccccccccccccccccccccccccccccccccccccbbbbcccccccccccoccccffffcccaaaaaaaaaaaaaaaaaa
Raaaaaaaacccccccccccccccccccccccccccddddccccccccczccccbbbbbbccccccpccccccqccccmccaaaaaaaaaaaaaaaaaaa
Raaaaaaacccccccccccccccccccccccaaaaaheeddcccmcccccccccbrbbbbbcccccccccccccccccccccaaaaaaaaaaaaaaaaaa
RaaaaaacccggcccccccccccccccccaaaaaaahheeHdscccccccccccbbbbbbbcccccccccccccccccccccaaaaaaaaaaaaaaaaaa
Raaaaaccgcgggcccccccccccccccaaaaaaaaahheedddddddcccccbbbbbbbbbcccccccccncccccccccccaaaaaaaaaaaaaaaaa
RaaaaaccgggjggcaccccccccccccaaaaaaaaaahheeeeeedddddddbbbbbbbbcccccccoccccActcccccccccaaaaaaaaaaaaaaa
Raaaaaaccggggccaacccaccccccaaaaaaaaaaaahhheeheeudddddddbbbbeeeeeeeecccccccccmccccccccaaaaaaaaaaaaaaa
Raaaaaaaccggggccaaaaaaaaaaaaaaaaaaaaaaaaahhhhheeddddddddbbeeeeeeeeeccccccccgggggggggcaaaaaaaaaaaaaaa
Raaaaaaaacgggggcaaaaaaaaaaaaaaaaaaaaaaaaaaaaahhedddddddddeeeeeeeeeeeeccccdggggggggggggaaaaaaaaaaaaaa
Raaaaaaaaacgggggaaaaaaaaaaaaaaaaaaaaaaaaaaaaaaheedeeedddeeeeeeeeeeeeeeedddggggdggggggaaaaaaaaaaaaaaa
Raaaaaaaaaagggggaaaaaaaaaaaaaaaaaaaaaaaaaaaaaahheeehedddeeeeeeeeeeeeeeeeddgggdddddggaaaaaaaaaaaaaaaa
Raaaaaaaaaacggggcaaaaaaaaaaaaaaaaaaaaaaaaaaaaaahhhhhedddeeeeeeeeeeeeeeeeddggddddddddaaaaaaaaaaaaaaaa
RaaaaaaaaaaacggggaaaaaaaaaaaaaaaaaaaaaaaaaaaaaaaaaheeBdddeeeeeeeIeeeeeeedddddddddddaaaaaaaaaaaaaaaaa
Raaaaaaaaaaacggggcaaaaaaaaaaaaaaaaaaaaaaaaaaaaaaaaddddddddeeeeeeeeeeeeeeddddddddddaaaaaaaaaaaaaaaaaa
RaaaaaaaaaaacggggggccaaaaaaaaaaaaaaaaaaaaaaaaaaaaddddddddddeeeeeeeeeeeeeddOJdPddddaaaaaaaaaaaaaaaaaa
RaaaaaaaaacgggggggggcccaaaaaaaaaaaaaaaaaaaaaaaaaddddCddDCdBdeeeeeeeeeeeeedddddddaaaaaaaaaaaaaaaaaaaa
RaaaaaaaaccgggcggccceeccaaaaaaaaaaaaaaaaaaaaaaaaddddddddddddeeeeeeeeeeLeeeddddKdaaaaaaaaaaaaaaaaaaaa
RaaaaaaaaceeeecccceeeeeehhhhhhaaaaaaaaaaaaaaaaaaadddddddddddeeeeeeeeeeeEeeeddNdaaaaaaaaaaaaaaaaaaaaa
RaaaaaaaheeeeeeeeeeeeeeeeeeeehhaaaaaaaaaaaaaaaaaadgggddFdCddeeeeeeeeeeeeeeedddaaaaaaaaaaaaaaaaaaaaaa
Raaaaaaaheeeeeeeeeeeeeeeeeeeeehhaaaaaaaaaaaaaaaaaagggggdddddeeeeeeeeeeeeeeeeaaaaaaaaaaaaaaaaaaaaaaaa
RaaaaaaaheeeeeeeeeeeeeeeeeeeeeehaaaaaaaaaaaaaaaaaaadggggBddeeeeeeeeeeeeeeeeehaaaaaaaaaaaaaaaaaaaaaaa
Raaaaaaaheeeeeeeeeeeeeeeeeeeeehhaaaaaaaaaaaaaaaaaaaadgggddeeeeeeeeeeeeeeeeeehaaaaaaaaaaaaaaaaaaaaaaa
Raaaaaahheeeeeeeeeeeeeeeeeeeeehaaaaaaaaaaaaaaaaaaaaaaadgeeeeeeeeeeeeeeeeeeeehaaaaaaaaaaaaaaaaaaaaaaa
Raaaaaaheeeeeeeeeeeeeeeeeeeeeehaaaaaaaaaaaaaaaaaaaaaaaaaaeeeeeeeeeeeeeeeeeehhaaaaaaaaaaaaaaaaaaaaaaa
Raaaahhheeeeeeeeeeeeeeeeeeeeeehaaaaaaaaaaaaaaaaaaaaaaaaaahheeeeeeeeehhhhhhhhaaaaaaaaaaaaaaaaaaaaaaaa
Raaahheheeeeeeeeeeeeeeeeeeeeeehaaaaaaaaaaaaaaaaaaaaaaaaaaahhhheeeehhhaaaaaaaaaaaaaaaaaaaaaaaaaaaaaaa
RaaaheeheeeeeeeMeeeeeeeeeeeeehhaaaaaaaaaaaaaaaaaaaaaaaaaaaaaahhhhhhaaaaaaaaaaaaahhhaaaaaaaaaaaaaaaaa
Raaahhhhheeeeeeeeeeeeeeeeeeehhaaaaaaaaaaaaaaaaaaaaaaaaaaaaaaaaaaaaaaaaaaaaaaaaahkhhhaaaaaaaaaaaaaaaa
Raaaaaaaheeeeeeeddddeeeeehhhhaaaaaaaaaaaaaaaaaaaaaaaaaaaaaaaaaaaaaaaaaaaaaaaaaaheeehaaaaaaaaaaaaaaaa
Raaaaaaahheeeeeedvddeeeehhaaaaaaaaaaaaaaaaaaaaaddaaaaaaaaaaaaaaaaaaaaaaaaaaaaaaheiehaaaaaaaaaaaaaaaa
RaaaaaaaaheeeeeeedTeeeeehaaaaaaaaaaaaaaaaaddaaggddaaaaaaaaaaaaaaaaaaaaaaaaaaaaaheeShaaaaaaaaaaaaaaaa
Raaaaaaaahheeeeeeeeeeeeehaaaaaaaaaaaaaaaaddgdgggdddaaaaaaaaaaaaaaaaaaaaaaaaaaaahhehhaadaaaaaaaaaaaaa
Raaaaaaaaahheeeeeeeeeeehhaaaaaaaaaaaaaaaadgggggddddaaaaaadaaddaaaaaddaaaaaaaaaaahhhaaaddaaaaaaaaaaaa
Raaaaaaaaaaheeeeeeeeeeehaaaaaaaaaaaaaaaaadgggguddddaaaaaaadaadaaadddadaaaaaaaaaaaaaaaaaddaaaaaaaaaaa
Raaaaaaaaaaabbeeeeeeeeehaaaaaaaaaaaaaaaaaaddggddddaaaddaaaaaaddaddaaadddaaaaaaaaaaaaaaaaaaaaaaaaaaaa
Raaaaaaaaaaabbbbbbeeeeehaaaaaaaaaaaaaaaaaaaddgdaaaaaadddaaaaaadaaaaaaaaaaaaaaaaaaaaaaaaaaaaaaaaaaaaa
Raaaaaaaaaaddbbbbbbeeehhaaaaaaaaaaaaaaaaaaaaaaaaaaaadddaaaaaaadaaaaaaaaaddaaaaaaaaaaaaaaaaaaaaaaaaaa
Raaaaaaaaaddbbbbbbbeehhaaaaaaaaaaaaaaaaaaaaaaaaaaaaaaaaaaaaaaaaaaaaaaaaaaddaaaaaaaaaaaaaaaaaaaaaaaaa
Raaaaaaaaaaddddddbbbhhaaaaaaaaaaaaaaaaaaaaaaaaaaaaaaaaaaaaaaaaaaaaaaaaaaaaaaaaaaaaaaaaaaaaaaaaaaaaaa
Raaaaaaaaaadaaddddaaaaaaaaaaaaaaaaaaaaaaaaaaaaaaaaaaaaaaaaaaaaaaaaaaaaaaaaaaaaaaaaaaaaaaaaaaaaaaaaaa
Raaaaaaaaaaaaaaadaaaaaaaaaaaaaaaaaaaaaaaaaaaaaaaaaaaaaaaaaaaaaaaaaaaaaaaaaaaaaaaaaaaaaaaaaaaaaaaaaaa
Raaaaaaaaaaaaaaaaaaaaaaaaaaaaaaaaaaaaaaaaaaaaaaaaaaaaaaaaaaaaaaaaaaaaaaaaaaaaaaaaaaaaaaaaaaaaaaaaaaa
"}
