"a" = (/turf/water,/area)
"b" = (/turf/dirt,/area)
"c" = (/turf/dgrass,/area)
"d" = (/turf/grass,/area)
"e" = (/turf/sand,/area)
"f" = (/turf/gravel,/area)
"g" = (/turf/Lgrass,/area)
"h" = (/turf/beach,/area)
"i" = (/obj/overworld/kamehouse,/turf/grass,/area)
"j" = (/obj/overworldstart,/turf/sand,/area)
"k" = (/obj/overworld/krillin_training,/turf/beach,/area)
"l" = (/obj/overworld/cellgames,/turf/dgrass,/area)
"m" = (/obj/overworld/city,/turf/dgrass,/area)
"n" = (/obj/overworld/pod,/turf/dgrass,/area)
"o" = (/obj/Rock/Rock5,/turf/dgrass,/area)
"p" = (/turf_overlays/rocks/rock6,/turf/dgrass,/area)
"q" = (/turf_overlays/rocks/rock4,/turf/dgrass,/area)
"r" = (/obj/Rock/Rock1,/turf/dirt,/area)
"s" = (/obj/overworld/ccpod,/turf/dgrass,/area)
"t" = (/obj/Rock/Rock6,/turf/dgrass,/area)
"u" = (/obj/overworld/city,/turf/grass,/area)
"v" = (/obj/overworld/budokai,/turf/grass,/area)
"w" = (/obj/overworld/tien_training,/turf/dgrass,/area)
"x" = (/obj/overworld/cell_training,/turf/dgrass,/area)
"y" = (/obj/overworld/piccolo_training,/turf/dgrass,/area)
"z" = (/obj/overworld/trunks_training,/turf/dgrass,/area)
"A" = (/obj/overworld/raditz_training,/turf/dgrass,/area)
"B" = (/obj/Rock/Rock6,/turf/grass,/area)
"C" = (/obj/Rock/Rock5,/turf/grass,/area)
"D" = (/obj/overworld/vegeta_training,/turf/grass,/area)
"E" = (/obj/overworld/yamcha_training,/turf/sand,/area)
"F" = (/obj/overworld/nappa_training,/turf/grass,/area)

(1,1,1) = {"
aaaaaaaaaaaaaaaaaaaaaaaaaaaaaaaaaaaaaaaaaaaaaaaaaaaaaaaaaaaaaaaaaaaaaaaaaaaaaaaaaaaaaaaaaaaaaaaaaaaa
aaaaaaaaaaaaaaaaaaaaaaaaaaaaaaaaaaaaaaaaaaaaaaaaaaaaaaaaaaaaaaaaaaaaaaaaaaaaaaaaaaaaaaaaaaaaaaaaaaaa
aaaaaaaaaaaaaaaaaaaaaaaaaaaaaaaaaaaaaaaaaaaaaaaaaaaaaaaaaaaaaaaaaaaaaaaaaaaaaaaaaaaaaaaaaaaaaaaaaaaa
aaaaaaaaaaaaaaaaaaaaaaaaaaaaaaaaaaaaaaaaaaaaaaaaaaaaaaaaaaaaaaaaaaaaaaaaaaaaaaaaaaaaaaaaaaaaaaaaaaaa
aaaaaaaaaaaaaaaaaaaaaaaaaaaaaaaaaaaaaaaaaaaaaaaaaaaaaaaaaaaaaaaaaaaaaaaaaaaaaaaaaaaaaaaaaaaaaaaaaaaa
aaaaaaaaaaaaaaaaaaaaaaaaaaaaaaaaaaaaaaaaaaaaaaaaaaaaaaaaaaaaaaaaaaaaaaaaaaaaaaaaaaaaaaaaaaaaaaaaaaaa
aaaaaaaaaaaaaaaaaaaaaaaaaaaaaaaaaaaaaaaaaaaaaaaaaaaaaaaaaaaaaaaaaaaaaaaaaaaaaaaaaaaaaaaaaaaaaaaaaaaa
aaaaaaaaaaaaaaaaaaaaaaaaaaaaaaaaaaaaaaaaaaaaaaaaaaaaaaaaaaaaaaaaaaaaaaaaaaaaaaaaaaaaaaaaaaaaaaaaaaaa
aaaaaaaaaaaaaaaaaaaaaaaaaaaaaaaaaaaaaaaaaaaaaaaaaaaaaaaaaaaaaaaaaaaaaaaaaaaaaaaaaaaaaaaaaaaaaaaaaaaa
aaaaaaaaaaaaaaaaaaaaaaaaaaaaaaaaaaaaaaaaaaaaaaaaaaaaaaaaaaaaaaaaaaaaaaaaaaaaaaaaaaaaaaaaaaaaaaaaaaaa
aaaaaaaaaaaaaaaaaaaaaaaaaaaaaaaaaaaaaaaaaaaaaaaaaaaaaaaaaaaaaaaaaaaaaaaaaaaaaaaaaaaaaaaaaaaaaaaaaaaa
aaaaaaaaaaaaaaaaaaaaaaaaaaaaaaaaaaaaaaaaaaaaaaaaaaaaaaaaaaaaaaaaaaaaaaaaaaaaaaaaaaaaaaaaaaaaaaaaaaaa
aaaaaaaaaaaaaaaaaaaaaaaaaaaaaaaaaaaaaaaaaaaaaaaaaaaaaaaaaaaaaaaaaaaaaaaaaaaaaaaaaaaaaaaaaaaaaaaaaaaa
aaaaaaaaaaaaaaaaaaaaaaaaaaaaaaaaaaaaaaaaaaaaaaaaaaaaaaaaaaaaaaaaaaaaaaaaaaaaaaaaaaaaaaaaaaaaaaaaaaaa
aaaaaaaaaaaaaaaaaaaaaaaaaaaaaaaaaaaaaaaaaaaaaaaaaaaaaaaaaaaaaaaaaaaaaaaaaaaaaaaaaaaaaaaaaaaaaaaaaaaa
aaaaaaaaaaaaaaaaaaaaaaaaaaaaaaaaaaaaaaaaaaaaaaaaaaaaaaaaaaaaaaaaaaaaaaaaaaaaaaaaaaaaaaaaaaaaaaaaaaaa
aaaaaaaaaaaaaaaaaaaaaaaaaaaaaaaaaaaaaaaaaaaaaaaaaaaaaaaaaaaaaaaaaaaaaaaaaaaaaaaaaaaaaaaaaaaaaaaaaaaa
aaaaaaaaaaaaaaaaaaaaaaaaaaaaaaaaaaaaaaaaaaaaaaaaaaaaaaaaaaaaaaaaaaaaaaaaaaaaaaaaaaaaaaaaaaaaaaaaaaaa
aaaaaaaaaaaaaaaaaaaaaaaaaaaaaaaaaaaaaaaaaaaaaaaaaaaaaaaaaaaaaaaaaaaaaaaaaaaaaaaaaaaaaaaaaaaaaaaaaaaa
aaaaaaaaaaaaaaaaaaaaaaaaaaaaaaaaaaaaaaaaaaaaaaaaaaaaaaaaaaaaaaaaaaaaaaaaaaaaaaaaaaaaaaaaaaaaaaaaaaaa
aaaaaaaaaaaaaaaaaaaaaaaaaaaaaaaaaaaaaaaaaaaaaaaaaaaaaaaaaaaaaaaaaaaaaaaaaaaaaaaaaaaaaaaaaaaaaaaaaaaa
aaaaaaaaaaaaaaaaaaaaaaaaaaaaaaaaaaaaaaaaaaaaaaaaaaaaaaaaaaaaaaaaaaaaaaaaaaaaaaaaaaaaaaaaaaaaaaaaaaaa
aaaaaaaaaaaaaaaaaaaaaaaaaaaaaaaaaaaaaaaaaaaaaaaaaaaaaaaaaaaaaaaaaaaaaaaaaaaaaaaaaaaaaaaaaaaaaaaaaaaa
aaaaaaaaaaaaaaaaaaaaaaaaaaaaaaaaaaaaaaaaaaaaaaaaaaaaaaaaaaaaaaaaaaaaaaaaaaaaaaaaaaaaaaaaaaaaaaaaaaaa
aaaaaaaaaaaaaaaaaaaaaaaaaaaaaaaaaaaaaaaaaaaaaaaaaaaaaaaaaaaaaaaaaaaaaaaaaaaaaaaaaaaaaaaaaaaaaaaaaaaa
aaaaaaaaaaaaaaaaaaaaaaaaaaaaaaaaaaaaaaaaaaaaaaaaaaaaaaaaaaaaaaaaaaaaaaaaaaaaaaaaaaaaaaaaaaaaaaaaaaaa
aaaaaaaaaaaaaaaaaaaaaaaaaaaaaaaaaaaaaaaaaaaaaaaaaaaaaaaaaaaaaaaaaaaaaaaaaaaaaaaaaaaaaaaaaaaaaaaaaaaa
aaaaaaaaaaaaaaaaaaaaaaaaaaaaaaaaaaaaaaaaaaaaaaaaaaaaaaaaaaaaaaaaaaaaaaaaaaaaaaaaaaaaaaaaaaaaaaaaaaaa
aaaaaaaaaaaaaaaaaaaaaaaaaaaaaaaaaaaaaaaaaaaaaaaaaaaaaaaaaaaaaaaaaaaaaaaaaaaaaaaaaaaaaaaaaaaaaaaaaaaa
aaaaaaaaaaaaaaaaaaaaaaaaaaaaaaaaaaaaaaaaaaaaaaaaaaaaaaaaaaaaaaaaaaaaaaaaaaaaaaaaaaaaaaaaaaaaaaaaaaaa
aaaaaaaaaaaaaaaaaaaaaaaaaaaaaaaaaaaaaaaaaaaaaaaaaaaaaaaaaaaaaaaaaaaaaaaaaaaaaaaaaaaaaaaaaaaaaaaaaaaa
aaaaaaaaaaaaaaaaaaaaaaaaaaaaaaaaaaaaaaaaaaaaaaaaaaaaaaaaaaaaaaaaaaaaaaaaaaaaaaaaaaaaaaaaaaaaaaaaaaaa
aaaaaaaaaaaaaaaaaaaaaaaaaaaaaaaaaaaaaaaaaaaaaaaaaaaaaaaaaaaaaaaaaaaaaaaaaaaaaaaaaaaaaaaaaaaaaaaaaaaa
aaaaaaaaaaaaaaaaaaaaaaaaaaaaaaaaaaaaaaaaaaaaaaaaaaaaaaaaaaaaaaaaaaaaaaaaaaaaaaaaaaaaaaaaaaaaaaaaaaaa
aaaaaaaaaaaaaaaaaaaaaaaaaaaaaaaaaaaaaaaaaaaaaaaaaaaaaaaaaaaaaaaaaaaaaaaaaaaaaaaaaaaaaaaaaaaaaaaaaaaa
aaaaaaaaaaaaaaaaaaaaaaaaaaaaaaaaaaaaaaaaaaaaaaaaaaaaaaaaaaaaaaaaaaaaaaaaaaaaaaaaaaaaaaaaaaaaaaaaaaaa
aaaaaaaaaaaaaaaaaaaaaaaaaaaaaaaaaaaaaaaaaaaaaaaaaaaaaaaaaaaaaaaaaaaaaaaaaaaaaaaaaaaaaaaaaaaaaaaaaaaa
aaaaaaaaaaaaaaaaaaaaaaaaaaaaaaaaaaaaaaaaaaaaaaaaaaaaaaaaaaaaaaaaaaaaaaaaaaaaaaaaaaaaaaaaaaaaaaaaaaaa
aaaaaaaaaaaaaaaaaaaaaaaaaaaaaaaaaaaaaaaaaaaaaaaaaaaaaaaaaaaaaaaaaaaaaaaaaaaaaaaaaaaaaaaaaaaaaaaaaaaa
aaaaaaaaaaaaaaaaaaaaaaaaaaaaaaaaaaaaaaaaaaaaaaaaaaaaaaaaaaaaaaaaaaaaaaaaaaaaaaaaaaaaaaaaaaaaaaaaaaaa
aaaaaaaaaaaaaaaaaaaaaaaaaaaaaaaaaaaaaaaaaaaaaaaaaaaaaaaaaaaaaaaaaaaaaaaaaaaaaaaaaaaaaaaaaaaaaaaaaaaa
aaaaaaaaaaaaaaaaaaaaaaaaaaaaaaaaaaaaaaaaaaaaaaaaaaaaaaaaaaaaaaaaaaaaaaaaaaaaaaaaaaaaaaaaaaaaaaaaaaaa
aaaaaaaaaaaaaaaaaaaaaaaaaaaaaaaaaaaaaaaaaaaaaaaaaaaaaaaaaaaaaaaaaaaaaaaaaaaaaaaaaaaaaaaaaaaaaaaaaaaa
aaaaaaaaaaaaaaaaaaaaaaaaaaaaaaaaaaaaaaaaaaaaaaaaaaaaaaaaaaaaaaaaaaaaaaaaaaaaaaaaaaaaaaaaaaaaaaaaaaaa
aaaaaaaaaaaaaaaaaaaaaaaaaaaaaaaaaaaaaaaaaaaaaaaaaaaaaaaaaaaaaaaaaaaaaaaaaaaaaaaaaaaaaaaaaaaaaaaaaaaa
aaaaaaaaaaaaaaaaaaaaaaaaaaaaaaaaaaaaaaaaaaaaaaaaaaaaaaaaaaaaaaaaaaaaaaaaaaaaaaaaaaaaaaaaaaaaaaaaaaaa
aaaaaaaaaaaaaaaaaaaaaaaaaaaaaaaaaaaaaaaaaaaaaaaaaacccccccccccaaaaaaaaaaaaaaaaaaaaaaaaaaaaaaaaaaaaaaa
aaaaaaaabaabbabccaaaaaaaaaaaaaaaaaaaaaaaaaaaaaaaaccccccccccccccccmcffaaaaaaafffffaaaaaaaaaaaaaaaaaaa
aaaaaaabbbbbbbcccaaaaaaaaaaaaaaaaaaaaaaccccccccccccccccccccccccccccfffffffffffffffaaaaaaaaaaaaaaaaaa
aaaaaabbbbbbbbccccaaaaaaaaaaaaaaaccccccccccccccccccccccccccccccccccfffffffffffffffaaaaaaaaaaaaaaaaaa
aaaaaabbbbbbbbcwccaaaaaaaaaaaaaccccccccccccccccccccccccccccccccccccfffffffffffffffaaaaaaaaaaaaaaaaaa
aaaaaabbbbbbbccccaaaaaaaaaaaacccccccccccccccccccccccccccccccccccccccffffffffffffffaaaaaaaaaaaaaaaaaa
aaaaaabbbbbbccccaaaaaacccaaaccccccccccccccccccccccccccccccccccccccccfffffffffffffffaaaaaaaaaaaaaaaaa
aaaaaaaabbbcccaaaaaccccccccccccccccccccccccccccccclcccccccccccccccccffffffffffffffffaaaaaaaaaaaaaaaa
aaaaaaaaaabcaaaacccccccccccccccccccccccccccccccccccxcccccccccccccccccfffffffffffffffaaaaaaaaaaaaaaaa
aaaaaaaaaaaaaacccccccccccccccccccccccccccccccccccccccccccccccccccccccccfffffffffffaaaaaaaaaaaaaaaaaa
aaaaaaaaaaacccccccccccccccccccccccccccccccccccccccccccccccccccccccccccccffffffffffaaaaaaaaaaaaaaaaaa
aaaaaaaaaaccccccccccccccccccccccccccccccccmccccccccccccccccccccccycccccccffffffffcaaaaaaaaaaaaaaaaaa
aaaaaaaaaacccccccccccccccccccccccccccccccccccccccccccccbbbbcccccccccccoccccffffcccaaaaaaaaaaaaaaaaaa
aaaaaaaaacccccccccccccccccccccccccccddddcccccmccczccccbbbbbbccccccpccccccqccccmccaaaaaaaaaaaaaaaaaaa
aaaaaaaacccccccccccccccccccccccaaaaaaeeddcccccccccccccbrbbbbbcccccccccccccccccccccaaaaaaaaaaaaaaaaaa
aaaaaaacccggcccccccccccccccccaaaaaaaaaeeddscccccccccccbbbbbbbcccccccccccccccccccccaaaaaaaaaaaaaaaaaa
aaaaaaccgcgggcccccccccccccccaaaaaaaaaaaeedddddddcccccbbbbbbbbbcccccccccncccccccccccaaaaaaaaaaaaaaaaa
aaaaaaccggggggcaccccccccccccaaaaaaaaaaaaeeddeddddddddbbbbbbbbcccccccoccccActcccccccccaaaaaaaaaaaaaaa
aaaaaaaccggggccaacccaccccccaaaaaaaaaaaaaaaeeaeeudddddddbbbbeeeeeeeecccccccccmccccccccaaaaaaaaaaaaaaa
aaaaaaaaccggggccaaaaaaaaaaaaaaaaaaaaaaaaaaaaaaeeddddddddbbeeeeeeeeecccccccccggggggggcaaaaaaaaaaaaaaa
aaaaaaaaacgggggcaaaaaaaaaaaaaaaaaaaaaaaaaaaaaaaedddddddddeeeeeeeeeeeeccccddggddgggggggaaaaaaaaaaaaaa
aaaaaaaaaacgggggaaaaaaaaaaaaaaaaaaaaaaaaaaaaaaaeddeeddddeeeeeeeeeeeeeeedddggddddddgggaaaaaaaaaaaaaaa
aaaaaaaaaaagggggaaaaaaaaaaaaaaaaaaaaaaaaaaaaaaaaeeeaedddeeeeeeeeeeeeeeeeddgdddddddddaaaaaaaaaaaaaaaa
aaaaaaaaaaacggggcaaaaaaaaaaaaaaaaaaaaaaaaaaaaaaaaaaaedddeeeeeeeeeeeeeeeeddddddddddddaaaaaaaaaaaaaaaa
aaaaaaaaaaaacggggaaaaaaaaaaaaaaaaaaaaaaaaaaaaaaaaaaeeBdddeeeeeeeeeeeeeeedddddddddddaaaaaaaaaaaaaaaaa
aaaaaaaaaaaacggggcaaaaaaaaaaaaaaaaaaaaaaaaaaaaaaaaddddddddeeeeeeeeeeeeeeddddddddddaaaaaaaaaaaaaaaaaa
aaaaaaaaaaaacggggggccaaaaaaaaaaaaaaaaaaaaaaaaaaaaddddddddddeeeeeeeeeeeeeddddddddddaaaaaaaaaaaaaaaaaa
aaaaaaaaaacgggggggggcccaaaaaaaaaaaaaaaaaaaaaaaaaddddCddDCdBdeeeeeeeeeeeeedddddddaaaaaaaaaaaaaaaaaaaa
aaaaaaaaaccgggcggccceeccaaaaaaaaaaaaaaaaaaaaaaaaddddddddddddeeeeeeeeeeeeeeddddddaaaaaaaaaaaaaaaaaaaa
aaaaaaaaaceeeecccceeeeeeaaaaaaaaaaaaaaaaaaaaaaaaadddddddddddeeeeeeeeeeeEeeeddddaaaaaaaaaaaaaaaaaaaaa
aaaaaaaaaeeeeeeeeeeeeeeeeeeeeaaaaaaaaaaaaaaaaaaaadgddddFdCddeeeeeeeeeeeeeeedddaaaaaaaaaaaaaaaaaaaaaa
aaaaaaaaaeeeeeeeeeeeeeeeeeeeeeaaaaaaaaaaaaaaaaaaaagggdddddddeeeeeeeeeeeeeeeeaaaaaaaaaaaaaaaaaaaaaaaa
aaaaaaaaaeeeeeeeeeeeeeeeeeeeeeeaaaaaaaaaaaaaaaaaaaadggddBddeeeeeeeeeeeeeeeeehaaaaaaaaaaaaaaaaaaaaaaa
aaaaaaaaaeeeeeeeeeeeeeeeeeeeeeaaaaaaaaaaaaaaaaaaaaaadggdddeeeeeeeeeeeeeeeeeehaaaaaaaaaaaaaaaaaaaaaaa
aaaaaaaaaeeeeeeeeeeeeeeeeeeeeeaaaaaaaaaaaaaaaaaaaaaaaadgeeeeeeeeeeeeeeeeeeeehaaaaaaaaaaaaaaaaaaaaaaa
aaaaaaaaeeeeeeeeeeeeeeeeeeeeeeaaaaaaaaaaaaaaaaaaaaaaaaaaaeeeeeeeeeeeeeeeeeehhaaaaaaaaaaaaaaaaaaaaaaa
aaaaaaaaeeeeeeeeeeeeeeeeeeeeeeaaaaaaaaaaaaaaaaaaaaaaaaaaahheeeeeeeeehhhhhhhhaaaaaaaaaaaaaaaaaaaaaaaa
aaaaaaeaeeeeeeeeeeeeeeeeeeeeeeaaaaaaaaaaaaaaaaaaaaaaaaaaaahhhheeeehhhaaaaaaaaaaaaaaaaaaaaaaaaaaaaaaa
aaaaaeeaeeeeeeeeeeeeeeeeeeeeeaaaaaaaaaaaaaaaaaaaaaaaaaaaaaaaahhhhhhaaaaaaaaaaaaahhhaaaaaaaaaaaaaaaaa
aaaaaaaaaeeeeeeeeeeeeeeeeeeeaaaaaaaaaaaaaaaaaaaaaaaaaaaaaaaaaaaaaaaaaaaaaaaaaaahkhhhaaaaaaaaaaaaaaaa
aaaaaaaaaeeeeeeeddddeeeeeaaaaaaaaaaaaaaaaaaaaaaaaaaaaaaaaaaaaaaaaaaaaaaaaaaaaaaheeehaaaaaaaaaaaaaaaa
aaaaaaaaaaeeeeeedvddeeeeaaaaaaaaaaaaaaaaaaaaaaaddaaaaaaaaaaaaaaaaaaaaaaaaaaaaaaheiehaaaaaaaaaaaaaaaa
aaaaaaaaaaeeeeeeeddeeeeeaaaaaaaaaaaaaaaaaaddaadgddaaaaaaaaaaaaaaaaaaaaaaaaaaaaaheeehaaaaaaaaaaaaaaaa
aaaaaaaaaaaeeeeeeeeeeeeeaaaaaaaaaaaaaaaaaddgddggdddaaaaaaaaaaaaaaaaaaaaaaaaaaaahhjhhaadaaaaaaaaaaaaa
aaaaaaaaaaaaeeeeeeeeeeeaaaaaaaaaaaaaaaaaadggdggddddaaaaaadaaddaaaaaddaaaaaaaaaaahhhaaaddaaaaaaaaaaaa
aaaaaaaaaaaaeeeeeeeeeeeaaaaaaaaaaaaaaaaaadgggguddddaaaaaaadaadaaadddadaaaaaaaaaaaaaaaaaddaaaaaaaaaaa
aaaaaaaaaaaabbeeeeeeeeeaaaaaaaaaaaaaaaaaaaddggddddaaaddaaaaaaddaddaaadddaaaaaaaaaaaaaaaaaaaaaaaaaaaa
aaaaaaaaaaaabbbbbbeeeeeaaaaaaaaaaaaaaaaaaaaddgdaaaaaadddaaaaaadaaaaaaaaaaaaaaaaaaaaaaaaaaaaaaaaaaaaa
aaaaaaaaaaaddbbbbbbeeeaaaaaaaaaaaaaaaaaaaaaaaaaaaaaadddaaaaaaadaaaaaaaaaddaaaaaaaaaaaaaaaaaaaaaaaaaa
aaaaaaaaaaddbbbbbbbeeaaaaaaaaaaaaaaaaaaaaaaaaaaaaaaaaaaaaaaaaaaaaaaaaaaaaddaaaaaaaaaaaaaaaaaaaaaaaaa
aaaaaaaaaaaddddddbbbaaaaaaaaaaaaaaaaaaaaaaaaaaaaaaaaaaaaaaaaaaaaaaaaaaaaaaaaaaaaaaaaaaaaaaaaaaaaaaaa
aaaaaaaaaaadaaddddaaaaaaaaaaaaaaaaaaaaaaaaaaaaaaaaaaaaaaaaaaaaaaaaaaaaaaaaaaaaaaaaaaaaaaaaaaaaaaaaaa
aaaaaaaaaaaaaaaadaaaaaaaaaaaaaaaaaaaaaaaaaaaaaaaaaaaaaaaaaaaaaaaaaaaaaaaaaaaaaaaaaaaaaaaaaaaaaaaaaaa
aaaaaaaaaaaaaaaaaaaaaaaaaaaaaaaaaaaaaaaaaaaaaaaaaaaaaaaaaaaaaaaaaaaaaaaaaaaaaaaaaaaaaaaaaaaaaaaaaaaa
"}
