"aa" = (/turf/water,/area)
"ab" = (/turf/dirt,/area)
"ac" = (/turf/dgrass,/area)
"ad" = (/turf/grass,/area)
"ae" = (/turf/sand,/area)
"af" = (/turf/gravel,/area)
"ag" = (/turf/Lgrass,/area)
"ah" = (/turf/water/beach,/area)
"ai" = (/obj/overworld/kamehouse{step_x = -14},/turf/grass,/area)
"aj" = (/obj/overworld/lookout,/turf/Lgrass,/area)
"ak" = (/obj/overworld/krillin_training,/turf/water/beach,/area)
"al" = (/obj/overworld/cellgames,/turf/dgrass,/area)
"am" = (/obj/overworld/city,/turf/dgrass,/area)
"an" = (/obj/overworld/pod,/turf/dgrass,/area)
"ao" = (/obj/Rock/Rock5,/turf/dgrass,/area)
"ap" = (/turf_overlays/rocks/rock6,/turf/dgrass,/area)
"aq" = (/turf_overlays/rocks/rock4,/turf/dgrass,/area)
"ar" = (/obj/Rock/Rock1,/turf/dirt,/area)
"as" = (/obj/overworld/ccpod,/turf/dgrass,/area)
"at" = (/obj/Rock/Rock6,/turf/dgrass,/area)
"au" = (/obj/overworld/city,/turf/grass,/area)
"av" = (/obj/overworld/budokai,/turf/grass,/area)
"aw" = (/obj/overworld/tien_training,/turf/grass,/area)
"ax" = (/obj/overworld/cell_training,/turf/dgrass,/area)
"ay" = (/obj/overworld/piccolo_training,/turf/dgrass,/area)
"az" = (/obj/overworld/trunks_training,/turf/dgrass,/area)
"aA" = (/obj/overworld/raditz_training,/turf/dgrass,/area)
"aB" = (/obj/Rock/Rock6,/turf/grass,/area)
"aC" = (/obj/Rock/Rock5,/turf/grass,/area)
"aD" = (/obj/overworld/vegeta_training,/turf/grass,/area)
"aE" = (/obj/overworld/yamcha_training,/turf/sand,/area)
"aF" = (/obj/overworld/nappa_training,/turf/grass,/area)
"aG" = (/obj/overworld/redribbonbase,/turf/gravel,/area)
"aH" = (/obj/overworld/capsulecorp,/turf/grass,/area)
"aI" = (/obj/overworld/pilafscastle,/turf/sand,/area)
"aJ" = (/obj/overworld/gokushouse,/turf/grass,/area)
"aK" = (/obj/overworld/grandpagohans,/turf/grass,/area)
"aL" = (/obj/overworld/yamchahideout,/turf/sand,/area)
"aM" = (/obj/overworld/baba,/turf/sand,/area)
"aN" = (/obj/overworldstart,/turf/grass,/area)
"aO" = (/obj/overworld/gohan_training,/turf/grass,/area)
"aP" = (/obj/overworld/goku_training,/turf/grass,/area)
"aQ" = (/obj/overworld/chaiotzu_training,/turf/dirt,/area)
"aR" = (/turf/water/grasswater,/area)
"aS" = (/obj/overworld/roshi_training,/turf/sand,/area)
"aT" = (/obj/overworld/satan_training,/turf/grass,/area)
"aU" = (/obj/Rock/Rock6,/turf/Lgrass,/area)
"aV" = (/turf/water{autotile_type = null},/area)
"aW" = (/obj/Rock/Rock5,/turf/dirt,/area)
"aX" = (/turf_overlays/rocks/rock4,/turf/dirt,/area)
"aY" = (/obj/Rock/Rock6,/turf/dirt,/area)
"aZ" = (/turf_overlays/rocks/rock5,/turf/dirt,/area)
"ba" = (/turf_overlays/rocks/rock6,/turf/grass,/area)
"bb" = (/turf/dgrass,/turf/dgrass,/area)

(1,1,1) = {"
aVaaaaaaaaaaaaaaaaaaaaaaaaaaaaaaaaaaaaaaaaaaaaaaaaaaaaaaaaaaaaaaaaaaaaaaaaaaaaaaaaaaaaaaaaaaaaaaaaaaaaaaaaaaaaaaaaaaaaaaaaaaaaaaaaaaaaaaaaaaaaaaaaaaaaaaaaaaaaaaaaaaaaaaaaaaaaaaaaaaaaaaaaaaaaaaaaaaaaaa
aVaaaaaaaaaaaaaaaaaaaaaaaaaaaaaaaaaaaaaaaaaaaaaaaaaaaaaaaaaaaaaaaaaaaaaaaaaaaaaaaaaaaaaaaaaaaaaaaaaaaaaaaaaaaaaaaaaaaaaaaaaaaaaaaaaaaaaaaaaaaaaaaaaaaaaaaaaaaaaaaaaaaaaaaaaaaaaaaaaaaaaaaaaaaaaaaaaaaaaa
aVaaaaaaaaaaaaaaaaaaaaaaaaaaaaaaaaaaaaaaaaaaaaaaaaaaaaaaaaaaaaaaaaaaaaaaaaaaaaaaaaaaaaaaaaaaaaaaaaaaaaaaaaaaaaaaaaaaaaaaaaaaaaaaaaaaaaaaaaaaaaaaaaaaaaaaaaaaaaaaaaaaaaaaaaaaaaaaaaaaaaaaaaaaaaaaaaaaaaaa
aVaaaaaaaaaaaaaaaaaaaaaaaaaaaaaaaaaaaaaaaaaaaaaaaaaaaaaaaaaaaaaaaaaaaaaaaaaaaaaaaaaaaaaaaaaaaaaaaaaaaaaaaaaaaaaaaaaaaaaaaaaaaaaaaaaaaaaaaaaaaaaaaaaaaaaaaaaaaaaaaaaaaaaaaaaaaaaaaaaaaaaaaaaaaaaaaaaaaaaa
aVaaaaaaaaaaaaaaaaaaaaaaaaaaaaaaaaaaaaaaaaaaaaaaaaaaaaaaaaaaaaaaaaaaaaaaaaaaaaaaaaaaaaaaaaaaaaaaaaaaaaaaaaaaaaaaaaaaaaaaaaaaaaaaaaaaaaaaaaaaaaaaaaaaaaaaaaaaaaaaaaaaaaaaaaaaaaaaaaaaaaaaaaaaaaaaaaaaaaaa
aVaaaaaaaaaaaaaaaaaaaaaaaaaaaaaaaaaaaaaaaaaaaaaaaaaaaaaaaaaaaaaaaaaaaaaaaaaaaaaaaaaaaaaaaaaaaaaaaaaaaaaaaaaaaaaaaaaaaaaaaaaaaaaaaaaaaaaaaaaaaaaaaaaaaaaaaaaaaaaaaaaaaaaaaaaaaaaaaaaaaaaaaaaaaaaaaaaaaaaa
aVaaaaaaaaaaaaaaaaaaaaaaaaaaaaaaaaaaaaaaaaaaaaaaaaaaaaaaaaaaaaaaaaaaaaaaaaaaaaaaaaaaaaaaaaaaaaaaaaaaaaaaaaaaaaaaaaaaaaaaaaaaaaaaaaaaaaaaaaaaaaaaaaaaaaaaaaaaaaaaaaaaaaaaaaaaaaaaaaaaaaaaaaaaaaaaaaaaaaaa
aVaaaaaaaaaaaaaaaaaaaaaaaaaaaaaaaaaaaaaaaaaaaaaaaaaaaaaaaaaaaaaaaaaaaaaaaaaaaaaaaaaaaaaaaaaaaaaaaaaaaaaaaaaaaaaaaaaaaaaaaaaaaaaaaaaaaaaaaaaaaaaaaaaaaaaaaaaaaaaaaaaaaaaaaaaaaaaaaaaaaaaaaaaaaaaaaaaaaaaa
aVaaaaaaaaaaaaaaaaaaaaaaaaaaaaaaaaaaaaaaaaaaaaaaaaaaaaaaaaaaaaaaaaaaaaaaaaaaaaaaaaaaaaaaaaaaaaaaaaaaaaaaaaaaaaaaaaaaaaaaaaaaaaaaaaaaaaaaaaaaaaaaaaaaaaaaaaaaaaaaaaaaaaaaaaaaaaaaaaaaaaaaaaaaaaaaaaaaaaaa
aVaaaaaaaaaaaaaaaaaaaaaaaaaaaaaaaaaaaaaaaaaaaaaaaaaaaaaaaaaaaaaaaaaaaaaaaaaaaaaaaaaaaaaaaaaaaaaaaaaaaaaaaaaaaaaaaaaaaaaaaaaaaaaaaaaaaaaaaaaaaaaaaaaaaaaaaaaaaaaaaaaaaaaaaaaaaaaaaaaaaaaaaaaaaaaaaaaaaaaa
aVaaaaaaaaaaaaaaaaaaaaaaaaaaaaaaaaaaaaaaaaaaaaaaaaaaaaaaaaaaaaaaaaaaaaaaaaaaaaaaaaaaaaaaaaaaaaaaaaaaaaaaaaaaaaaaaaaaaaaaaaaaaaaaaaaaaaaaaaaaaaaaaaaaaaaaaaaaaaaaaaaaaaaaaaaaaaaaaaaaaaaaaaaaaaaaaaaaaaaa
aVaaaaaaaaaaaaaaaaaaaaaaaaaaaaaaaaaaaaaaaaaaaaaaaaaaaaaaaaaaaaaaaaaaaaaaaaaaaaaaaaaaaaaaaaaaaaaaaaaaaaaaaaaaaaaaaaaaaaaaaaaaaaaaaaaaaaaaaaaaaaaaaaaaaaaaaaaaaaaaaaaaaaaaaaaaaaaaaaaaaaaaaaaaaaaaaaaaaaaa
aVaaaaaaaaaaaaaaaaaaaaaaaaaaaaaaaaaaaaaaaaaaaaaaaaaaaaaaaaaaaaaaaaaaaaaaaaaaaaaaaaaaaaaaaaaaaaaaaaaaaaaaaaaaaaaaaaaaaaaaaaaaaaaaaaaaaaaaaaaaaaaaaaaaaaaaaaaaaaaaaaaaaaaaaaaaaaaaaaaaaaaaaaaaaaaaaaaaaaaa
aVaaaaaaaaaaaaaaaaaaaaaaaaaaaaaaaaaaaaaaaaaaaaaaaaaaaaaaaaaaaaaaaaaaaaaaaaaaaaaaaaaaaaaaaaaaaaaaaaaaaaaaaaaaaaaaaaaaaaaaaaaaaaaaaaaaaaaaaaaaaaaaaaaaaaaaaaaaaaaaaaaaaaaaaaaaaaaaaaaaaaaaaaaaaaaaaaaaaaaa
aVaaaaaaaaaaaaaaaaaaaaaaaaaaaaaaaaaaaaaaaaaaaaaaaaaaaaaaaaaaaaaaaaaaaaaaaaaaaaaaaaaaaaaaaaaaaaaaaaaaaaaaaaaaaaaaaaaaaaaaaaaaaaaaaaaaaaaaaaaaaaaaaaaaaaaaaaaaaaaaaaaaaaaaaaaaaaaaaaaaaaaaaaaaaaaaaaaaaaaa
aVaaaaaaaaaaaaaaaaaaaaaaaaaaaaaaaaaaaaaaaaaaaaaaaaaaaaaaaaaaaaaaaaaaaaaaaaaaaaaaaaaaaaaaaaaaaaaaaaaaaaaaaaaaaaaaaaaaaaaaaaaaaaaaaaaaaaaaaaaaaaaaaaaaaaaaaaaaaaaaaaaaaaaaaaaaaaaaaaaaaaaaaaaaaaaaaaaaaaaa
aVaaaaaaaaaaaaaaaaaaaaaaaaaaaaaaaaaaaaaaaaaaaaaaaaaaaaaaaaaaaaaaaaaaaaaaaaaaaaaaaaaaaaaaaaaaaaaaaaaaaaaaaaaaaaaaaaaaaaaaaaaaaaaaaaaaaaaaaaaaaaaaaaaaaaaaaaaaaaaaaaaaaaaaaaaaaaaaaaaaaaaaaaaaaaaaaaaaaaaa
aVaaaaaaaaaaaaaaaaaaaaaaaaaaaaaaaaaaaaaaaaaaaaaaaaaaaaaaaaaaaaaaaaaaaaaaaaaaaaaaaaaaaaaaaaaaaaaaaaaaaaaaaaaaaaaaaaaaaaaaaaaaaaaaaaaaaaaaaaaaaaaaaaaaaaaaaaaaaaaaaaaaaaaaaaaaaaaaaaaaaaaaaaaaaaaaaaaaaaaa
aVaaaaaaaaaaaaaaaaaaaaaaaaaaaaaaaaaaaaaaaaaaaaaaaaaaaaaaaaaaaaaaaaaaaaaaaaaaaaaaaaaaaaaaaaaaaaaaaaaaaaaaaaaaaaaaaaaaaaaaaaaaaaaaaaaaaaaaaaaaaaaaaaaaaaaaaaaaaaaaaaaaaaaaaaaaaaaaaaaaaaaaaaaaaaaaaaaaaaaa
aVaaaaaaaaaaaaaaaaaaaaaaaaaaaaaaaaaaaaaaaaaaaaaaaaaaaaaaaaaaaaaaaaaaaaaaaaaaaaaaaaaaaaaaaaaaaaaaaaaaaaaaaaaaaaaaaaaaaaaaaaaaaaaaaaaaaaaaaaaaaaaaaaaaaaaaaaaaaaaaaaaaaaaaaaaaaaaaaaaaaaaaaaaaaaaaaaaaaaaa
aVaaaaaaaaaaaaaaaaaaaaaaaaaaaaaaaaaaaaaaaaaaaaaaaaaaaaaaaaaaaaaaaaaaaaaaaaaaaaaaaaaaaaaaaaaaaaaaaaaaaaaaaaaaaaaaaaaaaaaaaaaaaaaaaaaaaaaaaaaaaaaaaaaaaaaaaaaaaaaaaaaaaaaaaaaaaaaaaaaaaaaaaaaaaaaaaaaaaaaa
aVaaaaaaaaaaaaaaaaaaaaaaaaaaaaaaaaaaaaaaaaaaaaaaaaaaaaaaaaaaaaaaaaaaaaaaaaaaaaaaaaaaaaaaaaaaaaaaaaaaaaaaaaaaaaaaaaaaaaaaaaaaaaaaaaaaaaaaaaaaaaaaaaaaaaaaaaaaaaaaaaaaaaaaaaaaaaaaaaaaaaaaaaaaaaaaaaaaaaaa
aVaaaaaaaaaaaaaaaaaaaaaaaaaaaaaaaaaaaaaaaaaaaaaaaaaaaaaaaaaaaaaaaaaaaaaaaaaaaaaaaaaaaaaaaaaaaaaaaaaaaaaaaaaaaaaaaaaaaaaaaaaaaaaaaaaaaaaaaaaaaaaaaaaaaaaaaaaaaaaaaaaaaaaaaaaaaaaaaaaaaaaaaaaaaaaaaaaaaaaa
aVaaaaaaaaaaaaaaaaaaaaaaaaaaaaaaaaaaaaaaaaaaaaaaaaaaaaaaaaaaaaaaaaaaaaaaaaaaaaaaaaaaaaaaaaaaaaaaaaaaaaaaaaaaaaaaaaaaaaaaaaaaaaaaaaaaaaaaaaaaaaaaaaaaaaaaaaaaaaaaaaaaaaaaaaaaaaaaaaaaaaaaaaaaaaaaaaaaaaaa
aVaaaaaaaaaaaaaaaaaaaaaaaaaaaaaaaaaaaaaaaaaaaaaaaaaaaaaaaaaaaaaaaaaaaaaaaaaaaaaaaaaaaaaaaaaaaaaaaaaaaaaaaaaaaaaaaaaaaaaaaaaaaaaaaaaaaaaaaaaaaaaaaaaaaaaaaaaaaaaaaaaaaaaaaaaaaaaaaaaaaaaaaaaaaaaaaaaaaaaa
aVaaaaaaaaaaaaaaaaaaaaaaaaaaaaaaaaaaaaaaaaaaaaaaaaaaaaaaaaaaaaaaaaaaaaaaaaaaaaaaaaaaaaaaaaaaaaaaaaaaaaaaaaaaaaaaaaaaaaaaaaaaaaaaaaaaaaaaaaaaaaaaaaaaaaaaaaaaaaaaaaaaaaaaaaaaaaaaaaaaaaaaaaaaaaaaaaaaaaaa
aVaaaaaaaaaaaaaaaaaaaaaaaaaaaaaaaaaaaaaaaaaaaaaaaaaaaaaaaaaaaaaaaaaaaaaaaaaaaaaaaaaaaaaaaaaaaaaaaaaaaaaaaaaaaaaaaaaaaaaaaaaaaaaaaaaaaaaaaaaaaaaaaaaaaaaaaaaaaaaaaaaaaaaaaaaaaaaaaaaaaaaaaaaaaaaaaaaaaaaa
aVaaaaaaaaaaaaaaaaaaaaaaaaaaaaaaaaaaaaaaaaaaaaaaaaaaaaaaaaaaaaaaaaaaaaaaaaaaaaaaaaaaaaaaaaaaaaaaaaaaaaaaaaaaaaaaaaaaaaaaaaaaaaaaaaaaaaaaaaaaaaaaaaaaaaaaaaaaaaaaaaaaaaaaaaaaaaaaaaaaaaaaaaaaaaaaaaaaaaaa
aVaaaaaaaaaaaaaaaaaaaaaaaaaaaaaaaaaaaaaaaaaaaaaaaaaaaaaaaaaaaaaaaaaaaaaaaaaaaaaaaaaaaaaaaaaaaaaaaaaaaaaaaaaaaaaaaaaaaaaaaaaaaaaaaaaaaaaaaaaaaaaaaaaaaaaaaaaaaaaaaaaaaaaaaaaaaaaaaaaaaaaaaaaaaaaaaaaaaaaa
aVaaaaaaaaaaaaaaaaaaaaaaaaaaaaaaaaaaaaaaaaaaaaaaaaaaaaaaaaaaaaaaaaaaaaaaaaaaaaaaaaaaaaaaaaaaaaaaaaaaaaaaaaaaaaaaaaaaaaaaaaaaaaaaaaaaaaaaaaaaaaaaaaaaaaaaaaaaaaaaaaaaaaaaaaaaaaaaaaaaaaaaaaaaaaaaaaaaaaaa
aVaaaaaaaaaaaaaaaaaaaaaaaaaaaaaaaaaaaaaaaaaaaaaaaaaaaaaaaaaaaaaaaaaaaaaaaaaaaaaaaaaaaaaaaaaaaaaaaaaaaaaaaaaaaaaaaaaaaaaaaaaaaaaaaaaaaaaaaaaaaaaaaaaaaaaaaaaaaaaaaaaaaaaaaaaaaaaaaaaaaaaaaaaaaaaaaaaaaaaa
aVaaaaaaaaaaaaaaaaaaaaaaaaaaaaaaaaaaaaaaaaaaaaaaaaaaaaaaaaaaaaaaaaaaaaaaaaaaaaaaaaaaaaaaaaaaaaaaaaaaaaaaaaaaaaaaaaaaaaaaaaaaaaaaaaaaaaaaaaaaaaaaaaaaaaaaaaaaaaaaaaaaaaaaaaaaaaaaaaaaaaaaaaaaaaaaaaaaaaaa
aVaaaaaaaaaaaaaaaaaaaaaaaaaaaaaaaaaaaaaaaaaaaaaaaaaaaaaaaaaaaaaaaaaaaaaaaaaaaaaaaaaaaaaaaaaaaaaaaaaaaaaaaaaaaaaaaaaaaaaaaaaaaaaaaaaaaaaaaaaaaaaaaaaaaaaaaaaaaaaaaaaaaaaaaaaaaaaaaaaaaaaaaaaaaaaaaaaaaaaa
aVaaaaaaaaaaaaaaaaaaaaaaaaaaaaaaaaaaaaaaaaaaaaaaaaaaaaaaaaaaaaaaaaaaaaaaaaaaaaaaaaaaaaaaaaaaaaaaaaaaaaaaaaaaaaaaaaaaaaaaaaaaaaaaaaaaaaaaaaaaaaaaaaaaaaaaaaaaaaaaaaaaaaaaaaaaaaaaaaaaaaaaaaaaaaaaaaaaaaaa
aVaaaaaaaaaaaaaaaaaaaaaaaaaaaaaaaaaaaaaaaaaaaaaaaaaaaaaaaaaaaaaaaaaaaaaaaaaaaaaaaaaaaaaaaaaaaaaaaaaaaaaaaaaaaaaaaaaaaaaaaaaaaaaaaaaaaaaaaaaaaaaaaaaaaaaaaaaaaaaaaaaaaaaaaaaaaaaaaaaaaaaaaaaaaaaaaaaaaaaa
aVaaaaaaaaaaaaaaaaaaaaaaaaaaaaaaaaaaaaaaaaaaaaaaaaaaaaaaaaaaaaaaaaaaaaaaaaaaaaaaaaaaaaaaaaaaaaaaaaaaaaaaaaaaaaaaaaaaaaaaaaaaaaaaaaaaaaaaaaaaaaaaaaaaaaaaaaaaaaaaaaaaaaaaaaaaaaaaaaaaaaaaaaaaaaaaaaaaaaaa
aVaaaaaaaaaaaaaaaaaaaaaaaaaaaaaaaaaaaaaaaaaaaaaaaaaaaaaaaaaaaaaaaaaaaaaaaaaaaaaaaaaaaaaaaaaaaaaaaaaaaaaaaaaaaaaaaaaaaaaaaaaaaaaaaaaaaaaaaaaaaaaaaaaaaaaaaaaaaaaaaaaaaaaaaaaaaaaaaaaaaaaaaaaaaaaaaaaaaaaa
aVaaaaaaaaaaaaaaaaaaaaaaaaaaaaaaaaaaaaaaaaaaaaaaaaaaaaaaaaaaaaaaaaaaaaaaaaaaaaaaaaaaaaaaaaaaaaaaaaaaaaaaaaaaaaaaaaaaaaaaaaaaaaaaaaaaaaaaaaaaaaaaaaaaaaaaaaaaaaaaaaaaaaaaaaaaaaaaaaaaaaaaaaaaaaaaaaaaaaaa
aVaaaaaaaaaaaaaaaaaaaaaaaaaaaaaaaaaaaaaaaaaaaaaaaaaaaaaaaaaaaaaaaaaaaaaaaaaaaaaaaaaaaaaaaaaaaaaaaaaaaaaaaaaaaaaaaaaaaaaaaaaaaaaaaaaaaaaaaaaaaaaaaaaaaaaaaaaaaaaaaaaaaaaaaaaaaaaaaaaaaaaaaaaaaaaaaaaaaaaa
aVaaaaaaaaaaaaaaaaaaaaaaaaaaaaaaaaaaaaaaaaaaaaaaaaaaaaaaaaaaaaaaaaaaaaaaaaaaaaaaaaaaaaaaaaaaaaaaaaaaaaaaaaaaaaaaaaaaaaaaaaaaaaaaaaaaaaaaaaaaaaaaaaaaaaaaaaaaaaaaaaaaaaaaaaaaaaaaaaaaaaaaaaaaaaaaaaaaaaaa
aVaaaaaaaaaaaaaaaaaaaaaaaaaaaaaaaaaaaaaaaaaaaaaaaaaaaaaaaaaaaaaaaaaaaaaaaaaaaaaaaaaaaaaaaaaaaaaaaaaaaaaaaaaaaaaaaaaaaaaaaaaaaaaaaaaaaaaaaaaaaaaaaaaaaaaaaaaaaaaaaaaaaaaaaaaaaaaaaaaaaaaaaaaaaaaaaaaaaaaa
aVaaaaaaaaaaaaaaaaaaaaaaaaaaaaaaaaaaaaaaaaaaaaaaaaaaaaaaaaaaaaaaaaaaaaaaaaaaaaaaaaaaaaaaaaaaaaaaaaaaaaaaaaaaaaaaaaaaaaaaaaaaaaaaaaaaaaaaaaaaaaaaaaaaaaaaaaaaaaaaaaaaaaaaaaaaaaaaaaaaaaaaaaaaaaaaaaaaaaaa
aVaaaaaaaaaaaaaaaaaaaaaaaaaaaaaaaaaaaaaaaaaaaaaaaaaaaaaaaaaaaaaaaaaaaaaaaaaaaaaaaaaaaaaaaaaaaaaaaaaaaaaaaaaaaaaaaaaaaaaaaaaaaaaaaaaaaaaaaaaaaaaaaaaaaaaaaaaaaaaaaaaaaaaaaaaaaaaaaaaaaaaaaaaaaaaaaaaaaaaa
aVaaaaaaaaaaaaaaaaaaaaaaaaaaaaaaaaaaaaaaaaaaaaaaaaaaaaaaaaaaaaaaaaaaaaaaaaaaaaaaaaaaaaaaaaaaaaaaaaaaaaaaaaaaaaaaaaaaaaaaaaaaaaaaaaaaaaaaaaaaaaaaaaaaaaaaaaaaaaaaaaaaaaaaaaaaaaaaaaaaaaaaaaaaaaaaaaaaaaaa
aVaaaaaaaaaaaaaaaaaaaaaaaaaaaaaaaaaaaaaaaaaaaaaaaaaaaaaaaaaaaaaaaaaaaaaaaaaaaaaaaaaaaaaaaaaaaaaaaaaaaaaaaaaaaaaaaaaaaaaaaaaaaaaaaaaaaaaaaaaaaaaaaaaaaaaaaaaaaaaaaaaaaaaaaaaaaaaaaaaaaaaaaaaaaaaaaaaaaaaa
aVaaaaaaaaaaaaaaaaaaaaaaaaaaaaaaaaaaaaaaaaaaaaaaaaaaaaaaaaaaaaaaaaaaaaaaaaaaaaaaaaaaaaaaaaaaaaaaaaaRaRaRaRaRaRaRaRaRaRaRaRaRaaaaaaaaaaaaaaaaaaaaaaaaaaaaaaaaaaaaaaaaaaaaaaaaaaaaaaaaaaaaaaaaaaaaaaaaaaaa
aVaaaaaaaaaaaaaRaRaRaRaRaRaRaaaaaaaaaaaaaaaaaaaaaaaaaaaaaaaaaaaaaaaaaaaaaaaaaaaaaaaaaaaaaaaaaaaaaRaRadadadadadadadadadadadaRaRaRaRaRaRaRaRaRaaaaaaaaaaaRaRaRaRaRaRaRaaaaaaaaaaaaaaaaaaaaaaaaaaaaaaaaaaaa
aVaaaaaaaaaaaRaRadaRaRadadaRaRaRaRaaaaaaaaaaaaaaaaaaaaaaaaaaaaaaaaaaaaaaaaaaaRaRaRaRaRaRaRaRaRaRaRadadadadadadadadadadadadadadadadauadadadaRaRaRaRaRaRaRadadadadadaRaRaaaaaaaaaaaaaaaaaaaaaaaaaaaaaaaaaa
aVaaaaaaaaaRaRadadadadadadadadadaRaRaaaaaaaaaaaaaaaaaaaaaaaaaaaaaRaRaRaRaRaRaRadadadadadadadadadadadadadacacacacacacacacadadadadadadadadadadadadadadadadadafafafadadaRaaaaaaaaaaaaaaaaaaaaaaaaaaaaaaaaaa
aVaaaaaaaaaRadadababaWababaXadaCadaRaaaaaaaaaaaaaaaaaaaaaaaaaRaRaRadadadadadadadadadadadadadadadadadadacacacacacacacacacacacacacacacacafafafafafafafafafafafafafafadaRaaaaaaaaaaaaaaaaaaaaaaaaaaaaaaaaaa
aVaaaaaaaaaRadababababababaQadawaRaRaaaaaaaaaaaaaaaaaaaaaRaRaRadadadadadadadadadadadacacacacbbacacacacacacacacacacacacacacacacacacacacafafafafafafafafafafaGafafafadaRaaaaaaaaaaaaaaaaaaaaaaaaaaaaaaaaaa
aVaaaaaaaaaRadababaYabaZadadadaRaRaaaaaaaaaRaRaRaRaRaaaRaRadadadadadadadadadadacacacacacacacacacacacacacacacacacacacacacacacacacacacacacafafafafafafafafafafafafafadaRaRaaaaaaaaaaaaaaaaaaaaaaaaaaaaaaaa
aVaaaaaaaaaRadadadabadadadaRaRaRaaaaaRaRaRaRadadadaRaRaRadadadadadadacacacacacacacacacacacacacacacacacacacacacacacacacacacacacacacacacacafafafafafafafafafafafafafadadaRaRaaaaaaaaaaaaaaaaaaaaaaaaaaaaaa
aVaaaaaaaaaRaRaRadadbaaRaRaRaaaaaaaaaRadadadadadadadadadadadadadacacacacacacacacacacacacacacacacacacalacacacacacacacacacacacacacacacacacafafafafafafafafafafafafafadadadaRaaaaaaaaaaaaaaaaaaaaaaaaaaaaaa
aVaaaaaaaaaaaaaRaRaRadaRaaaaaaaaaRaRaRadadadadadadadadadadadacacacacacacacacacacacacacacacacacacacacacaxacacacacacacacacacacacacacacacacacafafafafafafafafafafafafadadadaRaaaaaaaaaaaaaaaaaaaaaaaaaaaaaa
aVaaaaaaaaaaaaaaaaaRaRaRaaaaaRaRaRadadadadadadadadadadacacacacacacacacacacacacacacacacacacacacacacacacacacacacacacacacacacacacacacacacacacacacafafafafafafafafafafadaRaRaRaaaaaaaaaaaaaaaaaaaaaaaaaaaaaa
aVaaaaaaaaaaaaaaaaaaaaaaaaaRaRadadadadadadadadadadacacacacacacacacacacacacacacacacacacacacacacacacacacacacacacacacacacacacacacacacacacacacacacacafafafafafafafafafadaRaaaaaaaaaaaaaaaaaaaaaaaaaaaaaaaaaa
aVaaaaaaaaaaaaaaaaaaaRaRaRaRadadadadadadadadadadadadacacacacacacacacacacacacacacacacamacacacacacacacacacacacacacacacacacacacacacacayacacacacacacacafafafafafafafafadaRaaaaaaaaaaaaaaaaaaaaaaaaaaaaaaaaaa
aVaaaaaaaaaaaaaaaaaaaRadadadadadadadadadadadadadadadacacacacadadadadadadadadacacacacacacacacacacacacacacacacacababababacacacacacacacacacacacaoacacacacafafafafacadadaRaaaaaaaaaaaaaaaaaaaaaaaaaaaaaaaaaa
aVaaaaaaaaaaaaaaaaaRaRadadadadadadadadadadadadadadadacacadadadadadadadadadadadadacacacacacacacacacazacacacacababababababacacacacacacapacacacacacacaqacacacacamacadadaRaaaaaaaaaaaaaaaaaaaaaaaaaaaaaaaaaa
aVaaaaaaaaaaaRaRaRaRadadadadadadadadadadadadadadadadadadadadadaRaRaRaRaRahaeaeadadacacacamacacacacacacacacacabarabababababacacacacacacacacacacacacacacacacacacacadadaRaaaaaaaaaaaaaaaaaaaaaaaaaaaaaaaaaa
aVaaaaaaaaaRaRadadadagagadadadadadadadadadadadadadadadadadaRaRaRaaaaaaaaahahaeaeaHadasacacacacacacacacacacacabababababababacacacacacacacacacacacacacacacacacacacacadaRaRaaaaaaaaaaaaaaaaaaaaaaaaaaaaaaaa
aVaaaaaaaaaRadadagadagagagadadadadadadadadadadadadadadadaRaRaaaaaaaaaaaaaaahahaeaeadadadadadadadacacacacacabababababababababacacacacacacacacacanacacacacacacacacacadadaRaRaRaaaaaaaaaaaaaaaaaaaaaaaaaaaa
aVaaaaaaaaaRadadagagagajagagadadadadadadadadadadadadadadaRaaaaaaaaaaaaaaaaaaahahaeaeaeaeaeaeadadadadadadadababababababababacacacacacacacaoacacacacaAacatacacacacacacadadadaRaaaaaaaaaaaaaaaaaaaaaaaaaaaa
aVaaaaaaaaaRaRadadagagagagadadaRaRaRaRaRaRadadadadadadaRaRaaaaaaaaaaaaaaaaaaaaahahahaeaeahaeaeauadadadadadadadababababaeaeaeaeaeaeaeaeacacacacacacacacacamacacacacacacacadaRaaaaaaaaaaaaaaaaaaaaaaaaaaaa
aVaaaaaaaaaaaRaRadadagagagagadaRaaaaaaaaaRaRaRaRaRaRaRaRaaaaaaaaaaaaaaaaaaaaaaaaaaahahahahahaeaeadadadadadadadadababaeaeaeaeaeaeaeaeaeacacacacacacacacagagagagagagagagagadaRaRaaaaaaaaaaaaaaaaaaaaaaaaaa
aVaaaaaaaaaaaaaRaRadadagagagadaRaRaaaaaaaaaaaaaaaaaaaaaaaaaaaaaaaaaaaaaaaaaaaaaaaaaaaaaaaaahahaeadadadadadadadadadaeaeaeaeaeaeaeaeaeaeaeaeacacacacadagagagagagagagagagagadadaRaaaaaaaaaaaaaaaaaaaaaaaaaa
aVaaaaaaaaaaaaaaaRaRadadagagadadaRaaaaaaaaaaaaaaaaaaaaaaaaaaaaaaaaaaaaaaaaaaaaaaaaaaaaaaaaaaahaeaeadaeaeaeadadadaeaeaeaeaeaeaeaeaeaeaeaeaeaeaeadadadagagagagadagagagagadadaRaRaaaaaaaaaaaaaaaaaaaaaaaaaa
aVaaaaaaaaaaaaaaaaaRaRadagagagadaRaRaaaaaaaaaaaaaaaaaaaaaaaaaaaaaaaaaaaaaaaaaaaaaaaaaaaaaaaaahahaeaeaeaeaeadadadaeaeaeaeaeaeaeaeaeaeaeaeaeaeaeaeadadagagagadadadadadagadaRaRaaaaaaaaaaaaaaaaaaaaaaaaaaaa
aVaaaaaaaaaaaaaaaaaaaRadadagagadadaRaaaaaaaaaaaaaaaaaaaaaaaaaaaaaaaaaaaaaaaaaaaaaaaaaaaaaaaaaaahahahadaeaeadadadaeaeaeaeaeaeaeaeaeaeaeaeaeaeaeaeadadagagadadadadadadadadaRaaaaaaaaaaaaaaaaaaaaaaaaaaaaaa
aVaaaaaaaaaaaaaaaaaaaRaRadagagagadaRaRaaaaaaaaaaaaaaaaaaaaaaaaaaaaaaaaaaaaaaaaaaaaaaaaaaaaaaaaaaaaaRadadaeaBadadadaeaeaeaeaeaeaeaIaeaeaeaeaeaeaeadadadadadadadadadadadaRaRaaaaaaaaaaaaaaaaaaaaaaaaaaaaaa
aVaaaaaaaaaaaaaaaaaaaaaRadagagagadadaRaRaRaRaaaaaaaaaaaaaaaaaaaaaaaaaaaaaaaaaaaaaaaaaaaaaaaaaaaaaRaRadadadadadadadadaeaeaeaeaeaeaeaeaeaeaeaeaeaeadadadadadadadadadadaRaRaaaaaaaaaaaaaaaaaaaaaaaaaaaaaaaa
aVaaaaaaaaaaaaaaaaaaaRaRadagagagagadadadadaRaRaRaaaaaaaaaaaaaaaaaaaaaaaaaaaaaaaaaaaaaaaaaaaaaaaRaRadadadadadadadadadadaeaeaeaeaeaeaeaeaeaeaeaeaeadadaOaJadaPadadadadaRaaaaaaaaaaaaaaaaaaaaaaaaaaaaaaaaaa
aVaaaaaaaaaaaaaaaRaRaRadadagagagagagagadadadadaRaRaaaaaaaaaaaaaaaaaaaaaaaaaaaaaaaaaaaaaaaaaaaaaRadadadadaCadadaDaCadaBadaeaeaeaeaeaeaeaeaeaeaeaeaeadadadadadadadaRaRaRaaaaaaaaaaaaaaaaaaaaaaaaaaaaaaaaaa
aVaaaaaaaaaaaaaaaRadadadagagadagagadadadaeaeadadaRaaaaaaaaaaaaaaaaaaaaaaaaaaaaaaaaaaaaaaaaaaaaaRadadadadadadadadadadadadaeaeaeaeaeaeaeaeaeaeaLaeaeaeadadadadaKadaRaaaaaaaaaaaaaaaaaaaaaaaaaaaaaaaaaaaaaa
aVaaaaaaaaaaaaaaaRadadaeaeaeadadadadaeaeaeaeaeaeahahahahahahaaaaaaaaaaaaaaaaaaaaaaaaaaaaaaaaaaaRaRadadadadadadadadadadadaeaeaeaeaeaeaeaeaeaeaeaEaeaeaeadadaNadaRaRaaaaaaaaaaaaaaaaaaaaaaaaaaaaaaaaaaaaaa
aVaaaaaaaaaaaaaaahaeaeaeaeaeaeaeaeaeaeaeaeaeaeaeaeaeaeaeaeahahaaaaaaaaaaaaaaaaaaaaaaaaaaaaaaaaaaaRaRaRadagagagaFadaCadadaeaeaeaeaeaeaeaeaeaeaeaeaeaeaeadadadaRaRaaaaaaaaaaaaaaaaaaaaaaaaaaaaaaaaaaaaaaaa
aVaaaaaaaaaaaaaaahaeaeaeaeaeaeaeaeaeaeaeaeaeaeaeaeaeaeaeaeaeahahaaaaaaaaaaaaaaaaaaaaaaaaaaaaaaaaaaaaaRadagagagagadadadadaeaeaeaeaeaeaeaeaeaeaeaeaeaeaeadaRaRaRaaaaaaaaaaaaaaaaaaaaaaaaaaaaaaaaaaaaaaaaaa
aVaaaaaaaaaaaaaaahaeaeaeaeaeaeaeaeaeaeaeaeaeaeaeaeaeaeaeaeaeaeahaaaaaaaaaaaaaaaaaaaaaaaaaaaaaaaaaaaaaRadadagagagaUadadaeaeaeaeaeaeaeaeaeaeaeaeaeaeaeaeaeahaaaaaaaaaaaaaaaaaaaaaaaaaaaaaaaaaaaaaaaaaaaaaa
aVaaaaaaaaaaaaaaahaeaeaeaeaeaeaeaeaeaeaeaeaeaeaeaeaeaeaeaeaeahahaaaaaaaaaaaaaaaaaaaaaaaaaaaaaaaaaaaaaRaRadadadagagadaeaeaeaeaeaeaeaeaeaeaeaeaeaeaeaeaeaeahaaaaaaaaaaaaaaaaaaaaaaaaaaaaaaaaaaaaaaaaaaaaaa
aVaaaaaaaaaaaaahahaeaeaeaeaeaeaeaeaeaeaeaeaeaeaeaeaeaeaeaeaeahaaaaaaaaaaaaaaaaaaaaaaaaaaaaaaaaaaaaaaaaaRaRaRadadaeaeaeaeaeaeaeaeaeaeaeaeaeaeaeaeaeaeaeaeahaaaaaaaaaaaaaaaaaaaaaaaaaaaaaaaaaaaaaaaaaaaaaa
aVaaaaaaaaaaaaahaeaeaeaeaeaeaeaeaeaeaeaeaeaeaeaeaeaeaeaeaeaeahaaaaaaaaaaaaaaaaaaaaaaaaaaaaaaaaaaaaaaaaaaaaaRaRaRahaeaeaeaeaeaeaeaeaeaeaeaeaeaeaeaeaeaeahahaaaaaaaaaaaaaaaaaaaaaaaaaaaaaaaaaaaaaaaaaaaaaa
aVaaaaaaaaahahahaeaeaeaeaeaeaeaeaeaeaeaeaeaeaeaeaeaeaeaeaeaeahaaaaaaaaaaaaaaaaaaaaaaaaaaaaaaaaaaaaaaaaaaaaaaaaaaahahahaeaeaeaeaeaeaeaeaeahahahahahahahahaaaaaaaaaaaaaaaaaaaaaaaaaaaaaaaaaaaaaaaaaaaaaaaa
aVaaaaaaahahaeahaeaeaeaeaeaeaeaeaeaeaeaeaeaeaeaeaeaeaeaeaeaeahaaaaaaaaaaaaaaaaaaaaaaaaaaaaaaaaaaaaaaaaaaaaaaaaaaaaaaahahahahaeaeaeaeahahahaaaaaaaaaaaaaaaaaaaaaaaaaaaaaaaaaaaaaaaaaaaaaaaaaaaaaaaaaaaaaa
aVaaaaaaahaeaeahaeaeaeaeaeaeaeaMaeaeaeaeaeaeaeaeaeaeaeaeaeahahaaaaaaaaaaaaaaaaaaaaaaaaaaaaaaaaaaaaaaaaaaaaaaaaaaaaaaaaaaaaahahahahahahaaaaaaaaaaaaaaaaaaaaaaaaaaahahahaaaaaaaaaaaaaaaaaaaaaaaaaaaaaaaaaa
aVaaaaaaahahahahahaeaeaeaeaeaeaeaeaeaeaeaeaeaeaeaeaeaeaeahahaaaaaaaaaaaaaaaaaaaaaaaaaaaaaaaaaaaaaaaaaaaaaaaaaaaaaaaaaaaaaaaaaaaaaaaaaaaaaaaaaaaaaaaaaaaaaaaaaaahakahahahaaaaaaaaaaaaaaaaaaaaaaaaaaaaaaaa
aVaaaaaaaaaaaaaaahaeaeaeaeaeaeaeadadadadaeaeaeaeaeahahahahaaaaaaaaaaaaaaaaaaaaaaaaaaaaaaaaaaaRaRaRaRaaaaaaaaaaaaaaaaaaaaaaaaaaaaaaaaaaaaaaaaaaaaaaaaaaaaaaaaaaahaeaeaeahaaaaaaaaaaaaaaaaaaaaaaaaaaaaaaaa
aVaaaaaaaaaaaaaaahahaeaeaeaeaeaeadavadadaeaeaeaeahahaaaaaaaaaaaaaaaaaaaaaaaaaaaaaaaRaRaRaRaRaRadadaRaRaaaaaaaaaaaaaaaaaaaaaaaaaaaaaaaaaaaaaaaaaaaaaaaaaaaaaaaaahaeaiaeahaaaaaaaaaaaaaaaaaaaaaaaaaaaaaaaa
aVaaaaaaaaaaaaaaaaahaeaeaeaeaeaeaeadaTaeaeaeaeaeahaaaaaaaaaaaaaaaaaaaaaaaaaaaaaaaRaRadadaRaRadadadadaRaRaaaaaaaaaaaaaaaaaaaaaaaaaaaaaaaaaaaaaaaaaaaaaaaaaaaaaaahaeaeaSahaaaRaRaRaaaaaaaaaaaaaaaaaaaaaaaa
aVaaaaaaaaaaaaaaaaahahaeaeaeaeaeaeaeaeaeaeaeaeaeahaaaaaaaaaaaaaaaaaaaaaaaaaaaaaaaRadadadadadadadadadadaRaaaaaaaaaRaRaRaRaRaRaRaaaaaaaRaRaRaRaaaaaaaaaaaaaaaaaaahahaeahahaaaRadaRaRaaaaaaaaaaaaaaaaaaaaaa
aVaaaaaaaaaaaaaaaaaaahahaeaeaeaeaeaeaeaeaeaeaeahahaaaaaaaaaaaaaaaaaaaaaaaaaaaaaaaRadagagagagagadadadadaRaaaaaaaaaRadaRaRadadaRaaaRaRaRadadaRaRaaaaaaaaaaaaaaaaaaahahahaaaaaRadadaRaRaaaaaaaaaaaaaaaaaaaa
aVaaaaaaaaaaaaaaaaaaaaahaeaeaeaeaeaeaeaeaeaeaeahaaaaaaaaaaaaaaaaaaaaaaaaaaaaaaaaaRadadagagagauadadadadaRaRaRaRaRaRaRadaRaRadaRaRaRadadadaRadaRaRaRaaaaaaaaaaaaaaaaaaaaaaaaaRaRadadaRaaaaaaaaaaaaaaaaaaaa
aVaaaaaaaaaaaaaaaaaaaaaRadabaeaeaeaeaeaeaeaeaeahaaaaaaaaaaaaaaaaaaaaaaaaaaaaaaaaaRaRadadagagadadadadaRaRaRadadaRaaaRaRaRaRadadaRadadaRaRaRadadadaRaaaaaaaaaaaaaaaaaaaaaaaaaaaRaRaRaRaaaaaaaaaaaaaaaaaaaa
aVaaaaaaaaaaaaaaaaaaaRaRadabababababaeaeaeaeaeahaaaaaaaaaaaaaaaaaaaaaaaaaaaaaaaaaaaRaRadadadadaRaRaRaRaRaRadadaRaRaaaaaaaRaRadaRaRaRaRaaaRaRaRaRaRaRaRaaaaaaaaaaaaaaaaaaaaaaaaaaaaaaaaaaaaaaaaaaaaaaaaaa
aVaaaaaaaaaaaaaaaaaRaRadadababababababaeaeaeahahaaaaaaaaaaaaaaaaaaaaaaaaaaaaaaaaaaaaaRaRaRaRaRaRaaaaaaaRadadadaRaRaaaaaaaaaRadaRaaaaaaaaaaaaaaaRadadaRaRaaaaaaaaaaaaaaaaaaaaaaaaaaaaaaaaaaaaaaaaaaaaaaaa
aVaaaaaaaaaaaaaaaaaRadadabababababababaeaeahahaaaaaaaaaaaaaaaaaaaaaaaaaaaaaaaaaaaaaaaaaaaaaaaaaaaaaaaaaRaRaRaRaRaaaaaaaaaaaRaRaRaaaaaaaaaaaaaaaRaRadadaRaaaaaaaaaaaaaaaaaaaaaaaaaaaaaaaaaaaaaaaaaaaaaaaa
aVaaaaaaaaaaaaaaaaaRaRadadadadadadadadadahahaaaaaaaaaaaaaaaaaaaaaaaaaaaaaaaaaaaaaaaaaaaaaaaaaaaaaaaaaaaaaaaaaaaaaaaaaaaaaaaaaaaaaaaaaaaaaaaaaaaaaRaRaRaRaaaaaaaaaaaaaaaaaaaaaaaaaaaaaaaaaaaaaaaaaaaaaaaa
aVaaaaaaaaaaaaaaaaaaaRadaRaRadadadadaRaRaRaaaaaaaaaaaaaaaaaaaaaaaaaaaaaaaaaaaaaaaaaaaaaaaaaaaaaaaaaaaaaaaaaaaaaaaaaaaaaaaaaaaaaaaaaaaaaaaaaaaaaaaaaaaaaaaaaaaaaaaaaaaaaaaaaaaaaaaaaaaaaaaaaaaaaaaaaaaaaa
aVaaaaaaaaaaaaaaaaaaaRaRaRaRaRaRadaRaRaaaaaaaaaaaaaaaaaaaaaaaaaaaaaaaaaaaaaaaaaaaaaaaaaaaaaaaaaaaaaaaaaaaaaaaaaaaaaaaaaaaaaaaaaaaaaaaaaaaaaaaaaaaaaaaaaaaaaaaaaaaaaaaaaaaaaaaaaaaaaaaaaaaaaaaaaaaaaaaaaa
aVaaaaaaaaaaaaaaaaaaaaaaaaaaaaaRaRaRaaaaaaaaaaaaaaaaaaaaaaaaaaaaaaaaaaaaaaaaaaaaaaaaaaaaaaaaaaaaaaaaaaaaaaaaaaaaaaaaaaaaaaaaaaaaaaaaaaaaaaaaaaaaaaaaaaaaaaaaaaaaaaaaaaaaaaaaaaaaaaaaaaaaaaaaaaaaaaaaaaaa
"}
