"a" = (/turf/water,/area)
"b" = (/turf/dirt,/area)
"c" = (/turf/dgrass,/area)
"d" = (/turf/grass,/area)
"e" = (/turf/sand,/area)
"f" = (/turf/gravel,/area)
"g" = (/turf/Lgrass,/area)
"h" = (/turf/beach,/area)
"i" = (/obj/overworld/kamehouse,/turf/grass,/area)
"j" = (/obj/overworldstart,/turf/sand,/area)
"k" = (/obj/overworld/krillin_training,/turf/beach,/area)

(1,1,1) = {"
aaaaaaaaaaaaaaaaaaaaaaaaaaaaaaaaaaaaaaaaaaaaaaaaaaaaaaaaaaaaaaaaaaaaaaaaaaaaaaaaaaaaaaaaaaaaaaaaaaaa
aaaaaaaaaaaaaaaaaaaaaaaaaaaaaaaaaaaaaaaaaaaaaaaaaaaaaaaaaaaaaaaaaaaaaaaaaaaaaaaaaaaaaaaaaaaaaaaaaaaa
aaaaaaaaaaaaaaaaaaaaaaaaaaaaaaaaaaaaaaaaaaaaaaaaaaaaaaaaaaaaaaaaaaaaaaaaaaaaaaaaaaaaaaaaaaaaaaaaaaaa
aaaaaaaaaaaaaaaaaaaaaaaaaaaaaaaaaaaaaaaaaaaaaaaaaaaaaaaaaaaaaaaaaaaaaaaaaaaaaaaaaaaaaaaaaaaaaaaaaaaa
aaaaaaaaaaaaaaaaaaaaaaaaaaaaaaaaaaaaaaaaaaaaaaaaaaaaaaaaaaaaaaaaaaaaaaaaaaaaaaaaaaaaaaaaaaaaaaaaaaaa
aaaaaaaaaaaaaaaaaaaaaaaaaaaaaaaaaaaaaaaaaaaaaaaaaaaaaaaaaaaaaaaaaaaaaaaaaaaaaaaaaaaaaaaaaaaaaaaaaaaa
aaaaaaaaaaaaaaaaaaaaaaaaaaaaaaaaaaaaaaaaaaaaaaaaaaaaaaaaaaaaaaaaaaaaaaaaaaaaaaaaaaaaaaaaaaaaaaaaaaaa
aaaaaaaaaaaaaaaaaaaaaaaaaaaaaaaaaaaaaaaaaaaaaaaaaaaaaaaaaaaaaaaaaaaaaaaaaaaaaaaaaaaaaaaaaaaaaaaaaaaa
aaaaaaaaaaaaaaaaaaaaaaaaaaaaaaaaaaaaaaaaaaaaaaaaaaaaaaaaaaaaaaaaaaaaaaaaaaaaaaaaaaaaaaaaaaaaaaaaaaaa
aaaaaaaaaaaaaaaaaaaaaaaaaaaaaaaaaaaaaaaaaaaaaaaaaaaaaaaaaaaaaaaaaaaaaaaaaaaaaaaaaaaaaaaaaaaaaaaaaaaa
aaaaaaaaaaaaaaaaaaaaaaaaaaaaaaaaaaaaaaaaaaaaaaaaaaaaaaaaaaaaaaaaaaaaaaaaaaaaaaaaaaaaaaaaaaaaaaaaaaaa
aaaaaaaaaaaaaaaaaaaaaaaaaaaaaaaaaaaaaaaaaaaaaaaaaaaaaaaaaaaaaaaaaaaaaaaaaaaaaaaaaaaaaaaaaaaaaaaaaaaa
aaaaaaaaaaaaaaaaaaaaaaaaaaaaaaaaaaaaaaaaaaaaaaaaaaaaaaaaaaaaaaaaaaaaaaaaaaaaaaaaaaaaaaaaaaaaaaaaaaaa
aaaaaaaaaaaaaaaaaaaaaaaaaaaaaaaaaaaaaaaaaaaaaaaaaaaaaaaaaaaaaaaaaaaaaaaaaaaaaaaaaaaaaaaaaaaaaaaaaaaa
aaaaaaaaaaaaaaaaaaaaaaaaaaaaaaaaaaaaaaaaaaaaaaaaaaaaaaaaaaaaaaaaaaaaaaaaaaaaaaaaaaaaaaaaaaaaaaaaaaaa
aaaaaaaaaaaaaaaaaaaaaaaaaaaaaaaaaaaaaaaaaaaaaaaaaaaaaaaaaaaaaaaaaaaaaaaaaaaaaaaaaaaaaaaaaaaaaaaaaaaa
aaaaaaaaaaaaaaaaaaaaaaaaaaaaaaaaaaaaaaaaaaaaaaaaaaaaaaaaaaaaaaaaaaaaaaaaaaaaaaaaaaaaaaaaaaaaaaaaaaaa
aaaaaaaaaaaaaaaaaaaaaaaaaaaaaaaaaaaaaaaaaaaaaaaaaaaaaaaaaaaaaaaaaaaaaaaaaaaaaaaaaaaaaaaaaaaaaaaaaaaa
aaaaaaaaaaaaaaaaaaaaaaaaaaaaaaaaaaaaaaaaaaaaaaaaaaaaaaaaaaaaaaaaaaaaaaaaaaaaaaaaaaaaaaaaaaaaaaaaaaaa
aaaaaaaaaaaaaaaaaaaaaaaaaaaaaaaaaaaaaaaaaaaaaaaaaaaaaaaaaaaaaaaaaaaaaaaaaaaaaaaaaaaaaaaaaaaaaaaaaaaa
aaaaaaaaaaaaaaaaaaaaaaaaaaaaaaaaaaaaaaaaaaaaaaaaaaaaaaaaaaaaaaaaaaaaaaaaaaaaaaaaaaaaaaaaaaaaaaaaaaaa
aaaaaaaaaaaaaaaaaaaaaaaaaaaaaaaaaaaaaaaaaaaaaaaaaaaaaaaaaaaaaaaaaaaaaaaaaaaaaaaaaaaaaaaaaaaaaaaaaaaa
aaaaaaaaaaaaaaaaaaaaaaaaaaaaaaaaaaaaaaaaaaaaaaaaaaaaaaaaaaaaaaaaaaaaaaaaaaaaaaaaaaaaaaaaaaaaaaaaaaaa
aaaaaaaaaaaaaaaaaaaaaaaaaaaaaaaaaaaaaaaaaaaaaaaaaaaaaaaaaaaaaaaaaaaaaaaaaaaaaaaaaaaaaaaaaaaaaaaaaaaa
aaaaaaaaaaaaaaaaaaaaaaaaaaaaaaaaaaaaaaaaaaaaaaaaaaaaaaaaaaaaaaaaaaaaaaaaaaaaaaaaaaaaaaaaaaaaaaaaaaaa
aaaaaaaaaaaaaaaaaaaaaaaaaaaaaaaaaaaaaaaaaaaaaaaaaaaaaaaaaaaaaaaaaaaaaaaaaaaaaaaaaaaaaaaaaaaaaaaaaaaa
aaaaaaaaaaaaaaaaaaaaaaaaaaaaaaaaaaaaaaaaaaaaaaaaaaaaaaaaaaaaaaaaaaaaaaaaaaaaaaaaaaaaaaaaaaaaaaaaaaaa
aaaaaaaaaaaaaaaaaaaaaaaaaaaaaaaaaaaaaaaaaaaaaaaaaaaaaaaaaaaaaaaaaaaaaaaaaaaaaaaaaaaaaaaaaaaaaaaaaaaa
aaaaaaaaaaaaaaaaaaaaaaaaaaaaaaaaaaaaaaaaaaaaaaaaaaaaaaaaaaaaaaaaaaaaaaaaaaaaaaaaaaaaaaaaaaaaaaaaaaaa
aaaaaaaaaaaaaaaaaaaaaaaaaaaaaaaaaaaaaaaaaaaaaaaaaaaaaaaaaaaaaaaaaaaaaaaaaaaaaaaaaaaaaaaaaaaaaaaaaaaa
aaaaaaaaaaaaaaaaaaaaaaaaaaaaaaaaaaaaaaaaaaaaaaaaaaaaaaaaaaaaaaaaaaaaaaaaaaaaaaaaaaaaaaaaaaaaaaaaaaaa
aaaaaaaaaaaaaaaaaaaaaaaaaaaaaaaaaaaaaaaaaaaaaaaaaaaaaaaaaaaaaaaaaaaaaaaaaaaaaaaaaaaaaaaaaaaaaaaaaaaa
aaaaaaaaaaaaaaaaaaaaaaaaaaaaaaaaaaaaaaaaaaaaaaaaaaaaaaaaaaaaaaaaaaaaaaaaaaaaaaaaaaaaaaaaaaaaaaaaaaaa
aaaaaaaaaaaaaaaaaaaaaaaaaaaaaaaaaaaaaaaaaaaaaaaaaaaaaaaaaaaaaaaaaaaaaaaaaaaaaaaaaaaaaaaaaaaaaaaaaaaa
aaaaaaaaaaaaaaaaaaaaaaaaaaaaaaaaaaaaaaaaaaaaaaaaaaaaaaaaaaaaaaaaaaaaaaaaaaaaaaaaaaaaaaaaaaaaaaaaaaaa
aaaaaaaaaaaaaaaaaaaaaaaaaaaaaaaaaaaaaaaaaaaaaaaaaaaaaaaaaaaaaaaaaaaaaaaaaaaaaaaaaaaaaaaaaaaaaaaaaaaa
aaaaaaaaaaaaaaaaaaaaaaaaaaaaaaaaaaaaaaaaaaaaaaaaaaaaaaaaaaaaaaaaaaaaaaaaaaaaaaaaaaaaaaaaaaaaaaaaaaaa
aaaaaaaaaaaaaaaaaaaaaaaaaaaaaaaaaaaaaaaaaaaaaaaaaaaaaaaaaaaaaaaaaaaaaaaaaaaaaaaaaaaaaaaaaaaaaaaaaaaa
aaaaaaaaaaaaaaaaaaaaaaaaaaaaaaaaaaaaaaaaaaaaaaaaaaaaaaaaaaaaaaaaaaaaaaaaaaaaaaaaaaaaaaaaaaaaaaaaaaaa
aaaaaaaaaaaaaaaaaaaaaaaaaaaaaaaaaaaaaaaaaaaaaaaaaaaaaaaaaaaaaaaaaaaaaaaaaaaaaaaaaaaaaaaaaaaaaaaaaaaa
aaaaaaaaaaaaaaaaaaaaaaaaaaaaaaaaaaaaaaaaaaaaaaaaaaaaaaaaaaaaaaaaaaaaaaaaaaaaaaaaaaaaaaaaaaaaaaaaaaaa
aaaaaaaaaaaaaaaaaaaaaaaaaaaaaaaaaaaaaaaaaaaaaaaaaaaaaaaaaaaaaaaaaaaaaaaaaaaaaaaaaaaaaaaaaaaaaaaaaaaa
aaaaaaaaaaaaaaaaaaaaaaaaaaaaaaaaaaaaaaaaaaaaaaaaaaaaaaaaaaaaaaaaaaaaaaaaaaaaaaaaaaaaaaaaaaaaaaaaaaaa
aaaaaaaaaaaaaaaaaaaaaaaaaaaaaaaaaaaaaaaaaaaaaaaaaaaaaaaaaaaaaaaaaaaaaaaaaaaaaaaaaaaaaaaaaaaaaaaaaaaa
aaaaaaaaaaaaaaaaaaaaaaaaaaaaaaaaaaaaaaaaaaaaaaaaaaaaaaaaaaaaaaaaaaaaaaaaaaaaaaaaaaaaaaaaaaaaaaaaaaaa
aaaaaaaaaaaaaaaaaaaaaaaaaaaaaaaaaaaaaaaaaaaaaaaaaaaaaaaaaaaaaaaaaaaaaaaaaaaaaaaaaaaaaaaaaaaaaaaaaaaa
aaaaaaaaaaaaaaaaaaaaaaaaaaaaaaaaaaaaaaaaaaaaaaaaaacccccccccccaaaaaaaaaaaaaaaaaaaaaaaaaaaaaaaaaaaaaaa
aaaaaaaabaabbabccaaaaaaaaaaaaaaaaaaaaaaaaaaaaaaaaccccccccccccccccccffaaaaaaafffffaaaaaaaaaaaaaaaaaaa
aaaaaaabbbbbbbcccaaaaaaaaaaaaaaaaaaaaaaccccccccccccccccccccccccccccfffffffffffffffaaaaaaaaaaaaaaaaaa
aaaaaabbbbbbbbccccaaaaaaaaaaaaaaaccccccccccccccccccccccccccccccccccfffffffffffffffaaaaaaaaaaaaaaaaaa
aaaaaabbbbbbbbccccaaaaaaaaaaaaaccccccccccccccccccccccccccccccccccccfffffffffffffffaaaaaaaaaaaaaaaaaa
aaaaaabbbbbbbccccaaaaaaaaaaaacccccccccccccccccccccccccccccccccccccccffffffffffffffaaaaaaaaaaaaaaaaaa
aaaaaabbbbbbccccaaaaaacccaaaccccccccccccccccccccccccccccccccccccccccfffffffffffffffaaaaaaaaaaaaaaaaa
aaaaaaaabbbcccaaaaacccccccccccccccccccccccccccccccccccccccccccccccccffffffffffffffffaaaaaaaaaaaaaaaa
aaaaaaaaaabcaaaacccccccccccccccccccccccccccccccccccccccccccccccccccccfffffffffffffffaaaaaaaaaaaaaaaa
aaaaaaaaaaaaaacccccccccccccccccccccccccccccccccccccccccccccccccccccccccfffffffffffaaaaaaaaaaaaaaaaaa
aaaaaaaaaaacccccccccccccccccccccccccccccccccccccccccccccccccccccccccccccffffffffffaaaaaaaaaaaaaaaaaa
aaaaaaaaaacccccccccccccccccccccccccccccccccccccccccccccccccccccccccccccccffffffffcaaaaaaaaaaaaaaaaaa
aaaaaaaaaacccccccccccccccccccccccccccccccccccccccccccccbbbbccccccccccccccccffffcccaaaaaaaaaaaaaaaaaa
aaaaaaaaacccccccccccccccccccccccccccddddccccccccccccccbbbbbbcccccccccccccccccccccaaaaaaaaaaaaaaaaaaa
aaaaaaaacccccccccccccccccccccccaaaaaaeeddcccccccccccccbbbbbbbcccccccccccccccccccccaaaaaaaaaaaaaaaaaa
aaaaaaacccggcccccccccccccccccaaaaaaaaaeeddccccccccccccbbbbbbbcccccccccccccccccccccaaaaaaaaaaaaaaaaaa
aaaaaaccgcgggcccccccccccccccaaaaaaaaaaaeedddddddcccccbbbbbbbbbcccccccccccccccccccccaaaaaaaaaaaaaaaaa
aaaaaaccggggggcaccccccccccccaaaaaaaaaaaaeeddeddddddddbbbbbbbbccccccccccccccccccccccccaaaaaaaaaaaaaaa
aaaaaaaccggggccaacccaccccccaaaaaaaaaaaaaaaeeaeeddddddddbbbbeeeeeeeeccccccccccccccccccaaaaaaaaaaaaaaa
aaaaaaaaccggggccaaaaaaaaaaaaaaaaaaaaaaaaaaaaaaeeddddddddbbeeeeeeeeecccccccccggggggggcaaaaaaaaaaaaaaa
aaaaaaaaacgggggcaaaaaaaaaaaaaaaaaaaaaaaaaaaaaaaedddddddddeeeeeeeeeeeeccccddggddgggggggaaaaaaaaaaaaaa
aaaaaaaaaacgggggaaaaaaaaaaaaaaaaaaaaaaaaaaaaaaaeddeeddddeeeeeeeeeeeeeeedddggddddddgggaaaaaaaaaaaaaaa
aaaaaaaaaaagggggaaaaaaaaaaaaaaaaaaaaaaaaaaaaaaaaeeeaedddeeeeeeeeeeeeeeeeddgdddddddddaaaaaaaaaaaaaaaa
aaaaaaaaaaacggggcaaaaaaaaaaaaaaaaaaaaaaaaaaaaaaaaaaaedddeeeeeeeeeeeeeeeeddddddddddddaaaaaaaaaaaaaaaa
aaaaaaaaaaaacggggaaaaaaaaaaaaaaaaaaaaaaaaaaaaaaaaaaeeddddeeeeeeeeeeeeeeedddddddddddaaaaaaaaaaaaaaaaa
aaaaaaaaaaaacggggcaaaaaaaaaaaaaaaaaaaaaaaaaaaaaaaaddddddddeeeeeeeeeeeeeeddddddddddaaaaaaaaaaaaaaaaaa
aaaaaaaaaaaacggggggccaaaaaaaaaaaaaaaaaaaaaaaaaaaaddddddddddeeeeeeeeeeeeeddddddddddaaaaaaaaaaaaaaaaaa
aaaaaaaaaacgggggggggcccaaaaaaaaaaaaaaaaaaaaaaaaaddddddddddddeeeeeeeeeeeeedddddddaaaaaaaaaaaaaaaaaaaa
aaaaaaaaaccgggcggccceeccaaaaaaaaaaaaaaaaaaaaaaaaddddddddddddeeeeeeeeeeeeeeddddddaaaaaaaaaaaaaaaaaaaa
aaaaaaaaaceeeecccceeeeeeaaaaaaaaaaaaaaaaaaaaaaaaadddddddddddeeeeeeeeeeeeeeeddddaaaaaaaaaaaaaaaaaaaaa
aaaaaaaaaeeeeeeeeeeeeeeeeeeeeaaaaaaaaaaaaaaaaaaaadgdddddddddeeeeeeeeeeeeeeedddaaaaaaaaaaaaaaaaaaaaaa
aaaaaaaaaeeeeeeeeeeeeeeeeeeeeeaaaaaaaaaaaaaaaaaaaagggdddddddeeeeeeeeeeeeeeeeaaaaaaaaaaaaaaaaaaaaaaaa
aaaaaaaaaeeeeeeeeeeeeeeeeeeeeeeaaaaaaaaaaaaaaaaaaaadggdddddeeeeeeeeeeeeeeeeehaaaaaaaaaaaaaaaaaaaaaaa
aaaaaaaaaeeeeeeeeeeeeeeeeeeeeeaaaaaaaaaaaaaaaaaaaaaadggdddeeeeeeeeeeeeeeeeeehaaaaaaaaaaaaaaaaaaaaaaa
aaaaaaaaaeeeeeeeeeeeeeeeeeeeeeaaaaaaaaaaaaaaaaaaaaaaaadgeeeeeeeeeeeeeeeeeeeehaaaaaaaaaaaaaaaaaaaaaaa
aaaaaaaaeeeeeeeeeeeeeeeeeeeeeeaaaaaaaaaaaaaaaaaaaaaaaaaaaeeeeeeeeeeeeeeeeeehhaaaaaaaaaaaaaaaaaaaaaaa
aaaaaaaaeeeeeeeeeeeeeeeeeeeeeeaaaaaaaaaaaaaaaaaaaaaaaaaaahheeeeeeeeehhhhhhhhaaaaaaaaaaaaaaaaaaaaaaaa
aaaaaaeaeeeeeeeeeeeeeeeeeeeeeeaaaaaaaaaaaaaaaaaaaaaaaaaaaahhhheeeehhhaaaaaaaaaaaaaaaaaaaaaaaaaaaaaaa
aaaaaeeaeeeeeeeeeeeeeeeeeeeeeaaaaaaaaaaaaaaaaaaaaaaaaaaaaaaaahhhhhhaaaaaaaaaaaaahhhaaaaaaaaaaaaaaaaa
aaaaaaaaaeeeeeeeeeeeeeeeeeeeaaaaaaaaaaaaaaaaaaaaaaaaaaaaaaaaaaaaaaaaaaaaaaaaaaahkhhhaaaaaaaaaaaaaaaa
aaaaaaaaaeeeeeeeeeeeeeeeeaaaaaaaaaaaaaaaaaaaaaaaaaaaaaaaaaaaaaaaaaaaaaaaaaaaaaaheeehaaaaaaaaaaaaaaaa
aaaaaaaaaaeeeeeeeeeeeeeeaaaaaaaaaaaaaaaaaaaaaaaddaaaaaaaaaaaaaaaaaaaaaaaaaaaaaaheiehaaaaaaaaaaaaaaaa
aaaaaaaaaaeeeeeeeeeeeeeeaaaaaaaaaaaaaaaaaaddaadgddaaaaaaaaaaaaaaaaaaaaaaaaaaaaaheeehaaaaaaaaaaaaaaaa
aaaaaaaaaaaeeeeeeeeeeeeeaaaaaaaaaaaaaaaaaddgddggdddaaaaaaaaaaaaaaaaaaaaaaaaaaaahhjhhaadaaaaaaaaaaaaa
aaaaaaaaaaaaeeeeeeeeeeeaaaaaaaaaaaaaaaaaadggdggddddaaaaaadaaddaaaaaddaaaaaaaaaaahhhaaaddaaaaaaaaaaaa
aaaaaaaaaaaaeeeeeeeeeeeaaaaaaaaaaaaaaaaaadggggdddddaaaaaaadaadaaadddadaaaaaaaaaaaaaaaaaddaaaaaaaaaaa
aaaaaaaaaaaabbeeeeeeeeeaaaaaaaaaaaaaaaaaaaddggddddaaaddaaaaaaddaddaaadddaaaaaaaaaaaaaaaaaaaaaaaaaaaa
aaaaaaaaaaaabbbbbbeeeeeaaaaaaaaaaaaaaaaaaaaddgdaaaaaadddaaaaaadaaaaaaaaaaaaaaaaaaaaaaaaaaaaaaaaaaaaa
aaaaaaaaaaaddbbbbbbeeeaaaaaaaaaaaaaaaaaaaaaaaaaaaaaadddaaaaaaadaaaaaaaaaddaaaaaaaaaaaaaaaaaaaaaaaaaa
aaaaaaaaaaddbbbbbbbeeaaaaaaaaaaaaaaaaaaaaaaaaaaaaaaaaaaaaaaaaaaaaaaaaaaaaddaaaaaaaaaaaaaaaaaaaaaaaaa
aaaaaaaaaaaddddddbbbaaaaaaaaaaaaaaaaaaaaaaaaaaaaaaaaaaaaaaaaaaaaaaaaaaaaaaaaaaaaaaaaaaaaaaaaaaaaaaaa
aaaaaaaaaaadaaddddaaaaaaaaaaaaaaaaaaaaaaaaaaaaaaaaaaaaaaaaaaaaaaaaaaaaaaaaaaaaaaaaaaaaaaaaaaaaaaaaaa
aaaaaaaaaaaaaaaadaaaaaaaaaaaaaaaaaaaaaaaaaaaaaaaaaaaaaaaaaaaaaaaaaaaaaaaaaaaaaaaaaaaaaaaaaaaaaaaaaaa
aaaaaaaaaaaaaaaaaaaaaaaaaaaaaaaaaaaaaaaaaaaaaaaaaaaaaaaaaaaaaaaaaaaaaaaaaaaaaaaaaaaaaaaaaaaaaaaaaaaa
"}
